cve_ent,cve_mun,nom_mun,Pob_total,Pob_masculina,Pob_femenina
01,001,Aguascalientes,948990,462073,486917
01,002,Asientos,51536,25261,26275
01,003,Calvillo,58250,28563,29687
01,004,Cos�o,17000,8292,8708
01,005,Jes�s Mar�a,129929,64219,65710
01,006,Pabell�n de Arteaga,47646,23377,24269
01,007,Rinc�n de Romos,57369,28101,29268
01,008,San Jos� de Gracia,9552,4532,5020
01,009,Tepezal�,22485,11114,11371
01,010,El Llano,20853,10446,10407
01,011,San Francisco de los Romo,61997,30705,31292
02,001,Ensenada,443807,221307,222500
02,002,Mexicali,1049792,529248,520544
02,003,Tecate,108440,57130,51310
02,004,Tijuana,1922523,968740,953783
02,005,Playas de Rosarito,126890,64386,62504
02,006,San Quint�n,117568,59778,57790
03,001,Comond�,73021,36804,36217
03,002,Muleg�,64022,33071,30951
03,003,La Paz,292241,145803,146438
03,008,Los Cabos,351111,180944,170167
03,009,Loreto,18052,9257,8795
04,001,Calkin�,59232,29170,30062
04,002,Campeche,294077,141555,152522
04,003,Carmen,248845,123043,125802
04,004,Champot�n,78170,39030,39140
04,005,Hecelchak�n,31917,15713,16204
04,006,Hopelch�n,42140,21328,20812
04,007,Palizada,8683,4423,4260
04,008,Tenabo,11452,5797,5655
04,009,Esc�rcega,59923,29468,30455
04,010,Calakmul,31714,16101,15613
04,011,Candelaria,46913,23674,23239
04,012,Seybaplaya,15297,7637,7660
05,001,Abasolo,1022,535,487
05,002,Acu�a,163058,81943,81115
05,003,Allende,23056,11446,11610
05,004,Arteaga,29578,14955,14623
05,005,Candela,1643,843,800
05,006,Casta�os,29128,14596,14532
05,007,Cuatro Ci�negas,12715,6365,6350
05,008,Escobedo,3047,1529,1518
05,009,Francisco I. Madero,59035,29217,29818
05,010,Frontera,82409,41209,41200
05,011,General Cepeda,11898,6091,5807
05,012,Guerrero,1643,883,760
05,013,Hidalgo,1735,896,839
05,014,Jim�nez,9502,4857,4645
05,015,Ju�rez,1584,786,798
05,016,Lamadrid,1764,928,836
05,017,Matamoros,118337,58692,59645
05,018,Monclova,237951,118058,119893
05,019,Morelos,7928,3935,3993
05,020,M�zquiz,71627,35856,35771
05,021,Nadadores,6539,3243,3296
05,022,Nava,33129,16599,16530
05,023,Ocampo,9642,4992,4650
05,024,Parras,44472,22534,21938
05,025,Piedras Negras,176327,88711,87616
05,026,Progreso,3239,1634,1605
05,027,Ramos Arizpe,122243,62722,59521
05,028,Sabinas,64811,32237,32574
05,029,Sacramento,2471,1242,1229
05,030,Saltillo,879958,437792,442166
05,031,San Buenaventura,24759,12275,12484
05,032,San Juan de Sabinas,42260,20922,21338
05,033,San Pedro,101041,49949,51092
05,034,Sierra Mojada,6744,3527,3217
05,035,Torre�n,720848,351753,369095
05,036,Viesca,20305,10230,10075
05,037,Villa Uni�n,6188,3130,3058
05,038,Zaragoza,13135,6557,6578
06,001,Armer�a,27626,13940,13686
06,002,Colima,157048,76155,80893
06,003,Comala,21661,10893,10768
06,004,Coquimatl�n,20837,10484,10353
06,005,Cuauht�moc,31267,15729,15538
06,006,Ixtlahuac�n,5623,2887,2736
06,007,Manzanillo,191031,95117,95914
06,008,Minatitl�n,10231,5234,4997
06,009,Tecom�n,116305,57829,58476
06,010,Villa de �lvarez,149762,72354,77408
07,001,Acacoyagua,17994,8997,8997
07,002,Acala,21187,10414,10773
07,003,Acapetahua,26899,13185,13714
07,004,Altamirano,36160,18032,18128
07,005,Amat�n,24512,12328,12184
07,006,Amatenango de la Frontera,31735,15428,16307
07,007,Amatenango del Valle,11283,5373,5910
07,008,�ngel Albino Corzo,31947,15905,16042
07,009,Arriaga,41135,19954,21181
07,010,Bejucal de Ocampo,7365,3652,3713
07,011,Bella Vista,20157,10002,10155
07,012,Berrioz�bal,64632,31914,32718
07,013,Bochil,37263,18208,19055
07,014,El Bosque,24273,11711,12562
07,015,Cacahoat�n,50112,24427,25685
07,016,Catazaj�,17619,8882,8737
07,017,Cintalapa,88106,43677,44429
07,018,Coapilla,9900,4873,5027
07,019,Comit�n de Dom�nguez,166178,79440,86738
07,020,La Concordia,49920,25133,24787
07,021,Copainal�,22192,10846,11346
07,022,Chalchihuit�n,21915,10873,11042
07,023,Chamula,101967,46948,55019
07,024,Chanal,13678,6734,6944
07,025,Chapultenango,7472,3735,3737
07,026,Chenalh�,47371,23194,24177
07,027,Chiapa de Corzo,112075,55166,56909
07,028,Chiapilla,6156,3106,3050
07,029,Chicoas�n,5402,2701,2701
07,030,Chicomuselo,36785,18139,18646
07,031,Chil�n,137262,67317,69945
07,032,Escuintla,30896,15214,15682
07,033,Francisco Le�n,7245,3673,3572
07,034,Frontera Comalapa,80897,39159,41738
07,035,Frontera Hidalgo,14556,7176,7380
07,036,La Grandeza,7701,3765,3936
07,037,Huehuet�n,36333,17711,18622
07,038,Huixt�n,22975,11264,11711
07,039,Huitiup�n,27893,13995,13898
07,040,Huixtla,53242,26079,27163
07,041,La Independencia,46409,22577,23832
07,042,Ixhuat�n,11377,5539,5838
07,043,Ixtacomit�n,10961,5419,5542
07,044,Ixtapa,28999,14286,14713
07,045,Ixtapangajoya,6284,3122,3162
07,046,Jiquipilas,41063,20370,20693
07,047,Jitotol,24966,12427,12539
07,048,Ju�rez,21807,10772,11035
07,049,Larr�inzar,31259,15204,16055
07,050,La Libertad,5232,2607,2625
07,051,Mapastepec,46130,22781,23349
07,052,Las Margaritas,141027,68891,72136
07,053,Mazapa de Madero,7901,3895,4006
07,054,Mazat�n,28250,14017,14233
07,055,Metapa,5876,2756,3120
07,056,Mitontic,13755,6733,7022
07,057,Motozintla,76398,37425,38973
07,058,Nicol�s Ru�z,4765,2440,2325
07,059,Ocosingo,234661,115769,118892
07,060,Ocotepec,14088,6879,7209
07,061,Ocozocoautla de Espinosa,97397,48070,49327
07,062,Ostuac�n,18469,9188,9281
07,063,Osumacinta,3983,1979,2004
07,064,Oxchuc,54932,27514,27418
07,065,Palenque,132265,65076,67189
07,066,Pantelh�,26391,12950,13441
07,067,Pantepec,12266,6054,6212
07,068,Pichucalco,31919,15652,16267
07,069,Pijijiapan,51193,25111,26082
07,070,El Porvenir,12263,6104,6159
07,071,Villa Comaltitl�n,30297,15578,14719
07,072,Pueblo Nuevo Solistahuac�n,29636,14432,15204
07,073,Ray�n,10866,5348,5518
07,074,Reforma,44829,21908,22921
07,075,Las Rosas,28829,14134,14695
07,076,Sabanilla,29889,14921,14968
07,077,Salto de Agua,64251,31846,32405
07,078,San Crist�bal de las Casas,215874,102292,113582
07,079,San Fernando,41793,20872,20921
07,080,Siltepec,25937,13026,12911
07,081,Simojovel,52935,25888,27047
07,082,Sital�,15518,7624,7894
07,083,Socoltenango,19092,9413,9679
07,084,Solosuchiapa,8561,4344,4217
07,085,Soyal�,10890,5465,5425
07,086,Suchiapa,25627,12756,12871
07,087,Suchiate,41672,20481,21191
07,088,Sunuapa,2308,1175,1133
07,089,Tapachula,353706,171610,182096
07,090,Tapalapa,4547,2209,2338
07,091,Tapilula,13592,6562,7030
07,092,Tecpat�n,21426,10664,10762
07,093,Tenejapa,48162,23308,24854
07,094,Teopisca,49499,23944,25555
07,096,Tila,83505,41701,41804
07,097,Tonal�,91913,45281,46632
07,098,Totolapa,7211,3640,3571
07,099,La Trinitaria,83111,40112,42999
07,100,Tumbal�,38025,18507,19518
07,101,Tuxtla Guti�rrez,604147,287524,316623
07,102,Tuxtla Chico,41024,19777,21247
07,103,Tuzant�n,30302,14900,15402
07,104,Tzimol,16560,8118,8442
07,105,Uni�n Ju�rez,16008,7847,8161
07,106,Venustiano Carranza,67292,33499,33793
07,107,Villa Corzo,65643,32345,33298
07,108,Villaflores,109536,53808,55728
07,109,Yajal�n,40285,19590,20695
07,110,San Lucas,7526,3792,3734
07,111,Zinacant�n,45373,21115,24258
07,112,San Juan Cancuc,37948,18517,19431
07,113,Aldama,8480,4040,4440
07,114,Benem�rito de las Am�ricas,23603,11814,11789
07,115,Maravilla Tenejapa,14714,7332,7382
07,116,Marqu�s de Comillas,12892,6498,6394
07,117,Montecristo de Guerrero,8412,4215,4197
07,118,San Andr�s Duraznal,6047,2928,3119
07,119,Santiago el Pinar,4959,2451,2508
07,120,Capit�n Luis �ngel Vidal,4315,2274,2041
07,121,Rinc�n Chamula San Pedro,8718,4027,4691
07,122,El Parral,15587,7591,7996
07,123,Emiliano Zapata,10783,5371,5412
07,124,Mezcalapa,23847,11699,12148
07,125,Honduras de la Sierra,11650,5897,5753
08,001,Ahumada,14635,7377,7258
08,002,Aldama,26047,12842,13205
08,003,Allende,8487,4256,4231
08,004,Aquiles Serd�n,24344,13494,10850
08,005,Ascensi�n,26093,13231,12862
08,006,Bach�niva,5807,2942,2865
08,007,Balleza,16440,8142,8298
08,008,Batopilas de Manuel G�mez Mor�n,11270,5597,5673
08,009,Bocoyna,23351,10978,12373
08,010,Buenaventura,25146,12509,12637
08,011,Camargo,49499,24447,25052
08,012,Carich�,8113,3996,4117
08,013,Casas Grandes,11815,6025,5790
08,014,Coronado,2034,1059,975
08,015,Coyame del Sotol,1230,633,597
08,016,La Cruz,3704,1881,1823
08,017,Cuauht�moc,180638,88417,92221
08,018,Cusihuiriachi,5099,2660,2439
08,019,Chihuahua,937674,457240,480434
08,020,Ch�nipas,6222,3156,3066
08,021,Delicias,150506,73827,76679
08,022,Dr. Belisario Dom�nguez,2456,1244,1212
08,023,Galeana,6656,3299,3357
08,024,Santa Isabel,3791,1864,1927
08,025,G�mez Far�as,7023,3465,3558
08,026,Gran Morelos,2448,1251,1197
08,027,Guachochi,50180,24298,25882
08,028,Guadalupe,4237,2133,2104
08,029,Guadalupe y Calvo,50514,25178,25336
08,030,Guazapares,8196,4105,4091
08,031,Guerrero,35473,17702,17771
08,032,Hidalgo del Parral,116662,56247,60415
08,033,Huejotit�n,824,411,413
08,034,Ignacio Zaragoza,5196,2605,2591
08,035,Janos,11005,5760,5245
08,036,Jim�nez,40859,20188,20671
08,037,Ju�rez,1512450,756977,755473
08,038,Julimes,4980,2517,2463
08,039,L�pez,4122,2117,2005
08,040,Madera,25144,12406,12738
08,041,Maguarichi,1302,621,681
08,042,Manuel Benavides,1178,626,552
08,043,Matach�,2742,1414,1328
08,044,Matamoros,4314,2163,2151
08,045,Meoqui,44853,22381,22472
08,046,Morelos,7266,3665,3601
08,047,Moris,4447,2334,2113
08,048,Namiquipa,22712,11390,11322
08,049,Nonoava,2757,1377,1380
08,050,Nuevo Casas Grandes,65753,32139,33614
08,051,Ocampo,8127,4110,4017
08,052,Ojinaga,24534,12193,12341
08,053,Praxedis G. Guerrero,5111,2599,2512
08,054,Riva Palacio,7695,3893,3802
08,055,Rosales,16776,8415,8361
08,056,Rosario,2079,1082,997
08,057,San Francisco de Borja,2197,1152,1045
08,058,San Francisco de Conchos,2696,1401,1295
08,059,San Francisco del Oro,5004,2484,2520
08,060,Santa B�rbara,11582,5817,5765
08,061,Satev�,3414,1805,1609
08,062,Saucillo,29862,14828,15034
08,063,Tem�sachic,5320,2666,2654
08,064,El Tule,1448,726,722
08,065,Urique,17043,8358,8685
08,066,Uruachi,6512,3288,3224
08,067,Valle de Zaragoza,4775,2419,2356
09,002,Azcapotzalco,432205,204950,227255
09,003,Coyoac�n,614447,289110,325337
09,004,Cuajimalpa de Morelos,217686,104149,113537
09,005,Gustavo A. Madero,1173351,563874,609477
09,006,Iztacalco,404695,192352,212343
09,007,Iztapalapa,1835486,887651,947835
09,008,La Magdalena Contreras,247622,118287,129335
09,009,Milpa Alta,152685,74371,78314
09,010,�lvaro Obreg�n,759137,361007,398130
09,011,Tl�huac,392313,190190,202123
09,012,Tlalpan,699928,334877,365051
09,013,Xochimilco,442178,215452,226726
09,014,Benito Ju�rez,434153,202121,232032
09,015,Cuauht�moc,545884,260951,284933
09,016,Miguel Hidalgo,414470,195467,219003
09,017,Venustiano Carranza,443704,210118,233586
10,001,Canatl�n,31454,15651,15803
10,002,Canelas,4321,2210,2111
10,003,Coneto de Comonfort,4084,2064,2020
10,004,Cuencam�,34955,17515,17440
10,005,Durango,688697,335412,353285
10,006,General Sim�n Bol�var,10038,4981,5057
10,007,G�mez Palacio,372750,184537,188213
10,008,Guadalupe Victoria,36695,18060,18635
10,009,Guanacev�,9869,5153,4716
10,010,Hidalgo,3843,1936,1907
10,011,Ind�,4748,2374,2374
10,012,Lerdo,163313,80856,82457
10,013,Mapim�,26932,13470,13462
10,014,Mezquital,48583,23858,24725
10,015,Nazas,12894,6525,6369
10,016,Nombre de Dios,19060,9508,9552
10,017,Ocampo,8003,4092,3911
10,018,El Oro,10384,5183,5201
10,019,Ot�ez,4924,2592,2332
10,020,P�nuco de Coronado,12656,6303,6353
10,021,Pe��n Blanco,11118,5612,5506
10,022,Poanas,25623,12619,13004
10,023,Pueblo Nuevo,51269,25382,25887
10,024,Rodeo,12818,6504,6314
10,025,San Bernardo,2837,1529,1308
10,026,San Dimas,17333,8871,8462
10,027,San Juan de Guadalupe,5251,2621,2630
10,028,San Juan del R�o,12013,5921,6092
10,029,San Luis del Cordero,2103,1066,1037
10,030,San Pedro del Gallo,1633,851,782
10,031,Santa Clara,6727,3354,3373
10,032,Santiago Papasquiaro,49207,24947,24260
10,033,S�chil,6917,3393,3524
10,034,Tamazula,26300,13506,12794
10,035,Tepehuanes,11378,5749,5629
10,036,Tlahualilo,21143,10537,10606
10,037,Topia,9320,4759,4561
10,038,Vicente Guerrero,23476,11480,11996
10,039,Nuevo Ideal,27981,13885,14096
11,001,Abasolo,92040,44853,47187
11,002,Ac�mbaro,108697,52208,56489
11,003,San Miguel de Allende,174615,83077,91538
11,004,Apaseo el Alto,63392,30550,32842
11,005,Apaseo el Grande,117883,57253,60630
11,006,Atarjea,5296,2583,2713
11,007,Celaya,521169,253045,268124
11,008,Manuel Doblado,41240,19777,21463
11,009,Comonfort,82216,38733,43483
11,010,Coroneo,11083,5270,5813
11,011,Cortazar,97928,47535,50393
11,012,Cuer�maro,30857,14867,15990
11,013,Doctor Mora,27390,13133,14257
11,014,Dolores Hidalgo Cuna de la Independencia Nacional,163038,76711,86327
11,015,Guanajuato,194500,94038,100462
11,016,Huan�maro,21128,9991,11137
11,017,Irapuato,592953,290770,302183
11,018,Jaral del Progreso,38782,18847,19935
11,019,Jer�cuaro,49517,23614,25903
11,020,Le�n,1721215,846673,874542
11,021,Morole�n,47261,22702,24559
11,022,Ocampo,26383,13502,12881
11,023,P�njamo,154960,74417,80543
11,024,Pueblo Nuevo,12403,5921,6482
11,025,Pur�sima del Rinc�n,83842,41334,42508
11,026,Romita,65766,32253,33513
11,027,Salamanca,273417,132278,141139
11,028,Salvatierra,94126,45447,48679
11,029,San Diego de la Uni�n,41054,19245,21809
11,030,San Felipe,119793,58087,61706
11,031,San Francisco del Rinc�n,130871,63982,66889
11,032,San Jos� Iturbide,89558,43419,46139
11,033,San Luis de la Paz,128536,60652,67884
11,034,Santa Catarina,5723,2693,3030
11,035,Santa Cruz de Juventino Rosas,82340,39162,43178
11,036,Santiago Maravat�o,6714,3219,3495
11,037,Silao de la Victoria,203556,100073,103483
11,038,Tarandacuao,11304,5494,5810
11,039,Tarimoro,35905,17400,18505
11,040,Tierra Blanca,20007,9660,10347
11,041,Uriangato,61494,29632,31862
11,042,Valle de Santiago,150054,72304,77750
11,043,Victoria,21253,9935,11318
11,044,Villagr�n,65791,31987,33804
11,045,Xich�,11143,5270,5873
11,046,Yuriria,68741,32858,35883
12,001,Acapulco de Ju�rez,779566,371794,407772
12,002,Ahuacuotzingo,25205,11762,13443
12,003,Ajuchitl�n del Progreso,37655,18378,19277
12,004,Alcozauca de Guerrero,21225,9895,11330
12,005,Alpoyeca,7813,3702,4111
12,006,Apaxtla,11112,5403,5709
12,007,Arcelia,33267,16059,17208
12,008,Atenango del R�o,9147,4412,4735
12,009,Atlamajalcingo del Monte,5811,2715,3096
12,010,Atlixtac,28491,13506,14985
12,011,Atoyac de �lvarez,60680,29479,31201
12,012,Ayutla de los Libres,69123,33478,35645
12,013,Azoy�,15099,7387,7712
12,014,Benito Ju�rez,15442,7568,7874
12,015,Buenavista de Cu�llar,12982,6250,6732
12,016,Coahuayutla de Jos� Mar�a Izazaga,12408,6259,6149
12,017,Cocula,15579,7631,7948
12,018,Copala,14463,6984,7479
12,019,Copalillo,15598,7476,8122
12,020,Copanatoyac,21648,10030,11618
12,021,Coyuca de Ben�tez,73056,35515,37541
12,022,Coyuca de Catal�n,38554,19025,19529
12,023,Cuajinicuilapa,26627,13184,13443
12,024,Cual�c,7874,3776,4098
12,025,Cuautepec,17024,8269,8755
12,026,Cuetzala del Progreso,8272,4092,4180
12,027,Cutzamala de Pinz�n,20537,10188,10349
12,028,Chilapa de �lvarez,123722,57741,65981
12,029,Chilpancingo de los Bravo,283354,134497,148857
12,030,Florencio Villarreal,22250,10907,11343
12,031,General Canuto A. Neri,6278,3055,3223
12,032,General Heliodoro Castillo,37254,18254,19000
12,033,Huamuxtitl�n,17488,8292,9196
12,034,Huitzuco de los Figueroa,36593,17509,19084
12,035,Iguala de la Independencia,154173,73936,80237
12,036,Igualapa,11739,5599,6140
12,037,Ixcateopan de Cuauht�moc,6138,2998,3140
12,038,Zihuatanejo de Azueta,126001,61437,64564
12,039,Juan R. Escudero,26093,12761,13332
12,040,Leonardo Bravo,26357,12797,13560
12,041,Malinaltepec,29625,13887,15738
12,042,M�rtir de Cuilapan,18613,8687,9926
12,043,Metlat�noc,18859,8775,10084
12,044,Mochitl�n,12402,6024,6378
12,045,Olinal�,28446,13509,14937
12,046,Ometepec,68207,33041,35166
12,047,Pedro Ascencio Alquisiras,7076,3352,3724
12,048,Petatl�n,44583,21892,22691
12,049,Pilcaya,12753,6243,6510
12,050,Pungarabato,38482,18789,19693
12,051,Quechultenango,36143,17348,18795
12,052,San Luis Acatl�n,46270,22643,23627
12,053,San Marcos,50124,24574,25550
12,054,San Miguel Totolapan,24139,11867,12272
12,055,Taxco de Alarc�n,105586,50365,55221
12,056,Tecoanapa,46063,22588,23475
12,057,T�cpan de Galeana,65237,32401,32836
12,058,Teloloapan,53817,25685,28132
12,059,Tepecoacuilco de Trujano,30806,14840,15966
12,060,Tetipac,13552,6598,6954
12,061,Tixtla de Guerrero,43171,20607,22564
12,062,Tlacoachistlahuaca,22781,10611,12170
12,063,Tlacoapa,10092,4733,5359
12,064,Tlalchapa,11681,5820,5861
12,065,Tlalixtaquilla de Maldonado,7602,3700,3902
12,066,Tlapa de Comonfort,96125,45021,51104
12,067,Tlapehuala,22209,10875,11334
12,068,La Uni�n de Isidoro Montes de Oca,26349,13361,12988
12,069,Xalpatl�huac,11966,5421,6545
12,070,Xochihuehuetl�n,7862,3740,4122
12,071,Xochistlahuaca,29891,14260,15631
12,072,Zapotitl�n Tablas,12004,5829,6175
12,073,Zir�ndaro,18031,9079,8952
12,074,Zitlala,21977,10051,11926
12,075,Eduardo Neri,53126,25725,27401
12,076,Acatepec,40197,19540,20657
12,077,Marquelia,14280,7027,7253
12,078,Cochoapa el Grande,21241,9929,11312
12,079,Jos� Joaqu�n de Herrera,18381,8791,9590
12,080,Juchit�n,7559,3818,3741
12,081,Iliatenco,11679,5566,6113
13,001,Acatl�n,22268,10705,11563
13,002,Acaxochitl�n,46065,21717,24348
13,003,Actopan,61002,29077,31925
13,004,Agua Blanca de Iturbide,10313,4913,5400
13,005,Ajacuba,18872,9108,9764
13,006,Alfajayucan,19162,9198,9964
13,007,Almoloya,12546,6070,6476
13,008,Apan,46681,22288,24393
13,009,El Arenal,19836,9575,10261
13,010,Atitalaquia,31525,15481,16044
13,011,Atlapexco,19812,9511,10301
13,012,Atotonilco el Grande,30135,14261,15874
13,013,Atotonilco de Tula,62470,30414,32056
13,014,Calnali,16150,7744,8406
13,015,Cardonal,19431,9308,10123
13,016,Cuautepec de Hinojosa,60421,28866,31555
13,017,Chapantongo,12967,6277,6690
13,018,Chapulhuac�n,22903,11262,11641
13,019,Chilcuautla,18909,9190,9719
13,020,Eloxochitl�n,2593,1239,1354
13,021,Emiliano Zapata,15175,7338,7837
13,022,Epazoyucan,16285,7879,8406
13,023,Francisco I. Madero,36248,17296,18952
13,024,Huasca de Ocampo,17607,8319,9288
13,025,Huautla,20673,9861,10812
13,026,Huazalingo,12766,6195,6571
13,027,Huehuetla,22846,11016,11830
13,028,Huejutla de Reyes,126781,61321,65460
13,029,Huichapan,47425,22780,24645
13,030,Ixmiquilpan,98654,46440,52214
13,031,Jacala de Ledezma,12290,5860,6430
13,032,Jaltoc�n,10523,5138,5385
13,033,Ju�rez Hidalgo,2895,1370,1525
13,034,Lolotla,9474,4577,4897
13,035,Metepec,13078,6185,6893
13,036,San Agust�n Metzquititl�n,9449,4582,4867
13,037,Metztitl�n,20962,10074,10888
13,038,Mineral del Chico,8878,4301,4577
13,039,Mineral del Monte,14324,6817,7507
13,040,La Misi�n,9819,4757,5062
13,041,Mixquiahuala de Ju�rez,47222,22625,24597
13,042,Molango de Escamilla,11578,5685,5893
13,043,Nicol�s Flores,6265,3036,3229
13,044,Nopala de Villagr�n,16948,8237,8711
13,045,Omitl�n de Ju�rez,9295,4422,4873
13,046,San Felipe Orizatl�n,38492,18728,19764
13,047,Pacula,4748,2230,2518
13,048,Pachuca de Soto,314331,149559,164772
13,049,Pisaflores,18723,9109,9614
13,050,Progreso de Obreg�n,23641,11165,12476
13,051,Mineral de la Reforma,202749,96259,106490
13,052,San Agust�n Tlaxiaca,38891,18950,19941
13,053,San Bartolo Tutotepec,17699,8737,8962
13,054,San Salvador,36796,17869,18927
13,055,Santiago de Anaya,18329,8946,9383
13,056,Santiago Tulantepec de Lugo Guerrero,39561,18646,20915
13,057,Singuilucan,15142,7379,7763
13,058,Tasquillo,17441,8146,9295
13,059,Tecozautla,38010,18137,19873
13,060,Tenango de Doria,17503,8395,9108
13,061,Tepeapulco,56245,26940,29305
13,062,Tepehuac�n de Guerrero,31235,15568,15667
13,063,Tepeji del R�o de Ocampo,90546,44062,46484
13,064,Tepetitl�n,10830,5255,5575
13,065,Tetepango,11768,5740,6028
13,066,Villa de Tezontepec,13032,6326,6706
13,067,Tezontepec de Aldama,55134,27089,28045
13,068,Tianguistengo,14340,7018,7322
13,069,Tizayuca,168302,82047,86255
13,070,Tlahuelilpan,19067,9304,9763
13,071,Tlahuiltepa,9086,4411,4675
13,072,Tlanalapa,11113,5366,5747
13,073,Tlanchinol,37722,18477,19245
13,074,Tlaxcoapan,28626,13906,14720
13,075,Tolcayuca,21362,10304,11058
13,076,Tula de Allende,115107,55588,59519
13,077,Tulancingo de Bravo,168369,79767,88602
13,078,Xochiatipan,18260,8843,9417
13,079,Xochicoatl�n,7015,3454,3561
13,080,Yahualica,24674,12060,12614
13,081,Zacualtip�n de �ngeles,38155,18137,20018
13,082,Zapotl�n de Ju�rez,21443,10342,11101
13,083,Zempoala,57906,27906,30000
13,084,Zimap�n,39927,18899,21028
14,001,Acatic,23175,11383,11792
14,002,Acatl�n de Ju�rez,25250,13244,12006
14,003,Ahualulco de Mercado,23630,11784,11846
14,004,Amacueca,5743,2776,2967
14,005,Amatit�n,16490,8184,8306
14,006,Ameca,60386,29564,30822
14,007,San Juanito de Escobedo,9433,4720,4713
14,008,Arandas,80609,39492,41117
14,009,El Arenal,21115,10345,10770
14,010,Atemajac de Brizuela,7758,3847,3911
14,011,Atengo,5599,2833,2766
14,012,Atenguillo,4176,2055,2121
14,013,Atotonilco el Alto,64009,31571,32438
14,014,Atoyac,8689,4214,4475
14,015,Autl�n de Navarro,64931,31886,33045
14,016,Ayotl�n,41552,20364,21188
14,017,Ayutla,12880,6414,6466
14,018,La Barca,67937,32851,35086
14,019,Bola�os,7043,3502,3541
14,020,Cabo Corrientes,10940,5644,5296
14,021,Casimiro Castillo,20548,10194,10354
14,022,Cihuatl�n,40139,19979,20160
14,023,Zapotl�n el Grande,115141,56188,58953
14,024,Cocula,29267,14395,14872
14,025,Colotl�n,19689,9482,10207
14,026,Concepci�n de Buenos Aires,6334,3198,3136
14,027,Cuautitl�n de Garc�a Barrag�n,18370,9347,9023
14,028,Cuautla,2166,1057,1109
14,029,Cuqu�o,17820,8655,9165
14,030,Chapala,55196,26815,28381
14,031,Chimaltit�n,3270,1624,1646
14,032,Chiquilistl�n,5983,2975,3008
14,033,Degollado,21226,10263,10963
14,034,Ejutla,1981,1007,974
14,035,Encarnaci�n de D�az,53039,25567,27472
14,036,Etzatl�n,20011,9784,10227
14,037,El Grullo,25920,12626,13294
14,038,Guachinango,4199,2154,2045
14,039,Guadalajara,1385629,666997,718632
14,040,Hostotipaquillo,8732,4368,4364
14,041,Huej�car,5920,2907,3013
14,042,Huejuquilla el Alto,10015,4838,5177
14,043,La Huerta,23258,11626,11632
14,044,Ixtlahuac�n de los Membrillos,67969,33422,34547
14,045,Ixtlahuac�n del R�o,20465,9976,10489
14,046,Jalostotitl�n,32678,16012,16666
14,047,Jamay,24894,12464,12430
14,048,Jes�s Mar�a,18982,8874,10108
14,049,Jilotl�n de los Dolores,9425,5053,4372
14,050,Jocotepec,47105,23229,23876
14,051,Juanacatl�n,30855,15259,15596
14,052,Juchitl�n,5534,2669,2865
14,053,Lagos de Moreno,172403,83977,88426
14,054,El Lim�n,5368,2670,2698
14,055,Magdalena,21781,10589,11192
14,056,Santa Mar�a del Oro,1815,914,901
14,057,La Manzanilla de la Paz,4099,2002,2097
14,058,Mascota,14451,7039,7412
14,059,Mazamitla,14043,6760,7283
14,060,Mexticac�n,5307,2447,2860
14,061,Mezquitic,22083,10615,11468
14,062,Mixtl�n,3638,1817,1821
14,063,Ocotl�n,106050,51775,54275
14,064,Ojuelos de Jalisco,33588,16258,17330
14,065,Pihuamo,11386,5674,5712
14,066,Poncitl�n,53659,26380,27279
14,067,Puerto Vallarta,291839,146187,145652
14,068,Villa Purificaci�n,11303,5695,5608
14,069,Quitupan,7734,3677,4057
14,070,El Salto,232852,121690,111162
14,071,San Crist�bal de la Barranca,2924,1465,1459
14,072,San Diego de Alejandr�a,7609,3739,3870
14,073,San Juan de los Lagos,72230,35728,36502
14,074,San Juli�n,16792,8051,8741
14,075,San Marcos,3791,1893,1898
14,076,San Mart�n de Bola�os,3095,1510,1585
14,077,San Mart�n Hidalgo,28102,13801,14301
14,078,San Miguel el Alto,31965,15549,16416
14,079,G�mez Far�as,16431,8078,8353
14,080,San Sebasti�n del Oeste,5086,2635,2451
14,081,Santa Mar�a de los �ngeles,3515,1716,1799
14,082,Sayula,37186,17984,19202
14,083,Tala,87690,43517,44173
14,084,Talpa de Allende,14997,7494,7503
14,085,Tamazula de Gordiano,38955,19120,19835
14,086,Tapalpa,21245,10561,10684
14,087,Tecalitl�n,16705,8256,8449
14,088,Tecolotl�n,16603,8231,8372
14,089,Techaluta de Montenegro,4072,2011,2061
14,090,Tenamaxtl�n,7302,3574,3728
14,091,Teocaltiche,39839,19159,20680
14,092,Teocuitatl�n de Corona,11039,5495,5544
14,093,Tepatitl�n de Morelos,150190,73710,76480
14,094,Tequila,44353,21891,22462
14,095,Teuchitl�n,9647,4709,4938
14,096,Tizap�n el Alto,22758,11179,11579
14,097,Tlajomulco de Z��iga,727750,360342,367408
14,098,San Pedro Tlaquepaque,687127,338844,348283
14,099,Tolim�n,11219,5565,5654
14,100,Tomatl�n,36316,18444,17872
14,101,Tonal�,569913,281695,288218
14,102,Tonaya,5961,2898,3063
14,103,Tonila,7565,3769,3796
14,104,Totatiche,4180,2115,2065
14,105,Tototl�n,23573,11562,12011
14,106,Tuxcacuesco,5482,2784,2698
14,107,Tuxcueca,6702,3247,3455
14,108,Tuxpan,37518,18352,19166
14,109,Uni�n de San Antonio,19069,9323,9746
14,110,Uni�n de Tula,13799,6684,7115
14,111,Valle de Guadalupe,6627,3269,3358
14,112,Valle de Ju�rez,6151,2990,3161
14,113,San Gabriel,16548,8197,8351
14,114,Villa Corona,19063,9490,9573
14,115,Villa Guerrero,5525,2762,2763
14,116,Villa Hidalgo,20088,9670,10418
14,117,Ca�adas de Obreg�n,4388,2191,2197
14,118,Yahualica de Gonz�lez Gallo,22394,10713,11681
14,119,Zacoalco de Torres,30472,15362,15110
14,120,Zapopan,1476491,720592,755899
14,121,Zapotiltic,33713,16627,17086
14,122,Zapotitl�n de Vadillo,7466,3774,3692
14,123,Zapotl�n del Rey,19279,9499,9780
14,124,Zapotlanejo,64806,31882,32924
14,125,San Ignacio Cerro Gordo,18341,8914,9427
15,001,Acambay de Ru�z Casta�eda,67872,32617,35255
15,002,Acolman,171507,86228,85279
15,003,Aculco,49266,24089,25177
15,004,Almoloya de Alquisiras,15333,7281,8052
15,005,Almoloya de Ju�rez,174587,87130,87457
15,006,Almoloya del R�o,12694,6150,6544
15,007,Amanalco,23675,11534,12141
15,008,Amatepec,25244,12247,12997
15,009,Amecameca,53441,25440,28001
15,010,Apaxco,31898,15633,16265
15,011,Atenco,75489,37052,38437
15,012,Atizap�n,12984,6287,6697
15,013,Atizap�n de Zaragoza,523674,253429,270245
15,014,Atlacomulco,109384,52218,57166
15,015,Atlautla,31900,15585,16315
15,016,Axapusco,29128,14287,14841
15,017,Ayapango,10053,4810,5243
15,018,Calimaya,68489,33388,35101
15,019,Capulhuac,36921,17778,19143
15,020,Coacalco de Berrioz�bal,293444,141107,152337
15,021,Coatepec Harinas,38643,18560,20083
15,022,Cocotitl�n,15107,7350,7757
15,023,Coyotepec,40885,19992,20893
15,024,Cuautitl�n,178847,87666,91181
15,025,Chalco,400057,193129,206928
15,026,Chapa de Mota,31737,15524,16213
15,027,Chapultepec,12772,6165,6607
15,028,Chiautla,30045,14668,15377
15,029,Chicoloapan,200750,97195,103555
15,030,Chiconcuac,27692,13548,14144
15,031,Chimalhuac�n,705193,344571,360622
15,032,Donato Guerra,37436,18391,19045
15,033,Ecatepec de Morelos,1645352,798549,846803
15,034,Ecatzingo,10827,5321,5506
15,035,Huehuetoca,163244,80016,83228
15,036,Hueypoxtla,46757,23108,23649
15,037,Huixquilucan,284965,136466,148499
15,038,Isidro Fabela,11929,5817,6112
15,039,Ixtapaluca,542211,263083,279128
15,040,Ixtapan de la Sal,36911,17676,19235
15,041,Ixtapan del Oro,6475,3215,3260
15,042,Ixtlahuaca,160139,76775,83364
15,043,Xalatlaco,30687,14952,15735
15,044,Jaltenco,28217,13645,14572
15,045,Jilotepec,87671,42810,44861
15,046,Jilotzingo,19877,9719,10158
15,047,Jiquipilco,76826,36464,40362
15,048,Jocotitl�n,69264,33245,36019
15,049,Joquicingo,15428,7543,7885
15,050,Juchitepec,27116,13143,13973
15,051,Lerma,170327,83968,86359
15,052,Malinalco,28155,13833,14322
15,053,Melchor Ocampo,61220,29907,31313
15,054,Metepec,242307,115997,126310
15,055,Mexicaltzingo,13807,6753,7054
15,056,Morelos,33164,15970,17194
15,057,Naucalpan de Ju�rez,834434,402495,431939
15,058,Nezahualc�yotl,1077208,519922,557286
15,059,Nextlalpan,57082,27988,29094
15,060,Nicol�s Romero,430601,209774,220827
15,061,Nopaltepec,10351,5090,5261
15,062,Ocoyoacac,72103,35221,36882
15,063,Ocuilan,36223,17645,18578
15,064,El Oro,36937,17918,19019
15,065,Otumba,36331,18197,18134
15,066,Otzoloapan,4891,2397,2494
15,067,Otzolotepec,88783,43447,45336
15,068,Ozumba,30785,14752,16033
15,069,Papalotla,4862,2338,2524
15,070,La Paz,304088,148202,155886
15,071,Polotitl�n,14985,7329,7656
15,072,Ray�n,15972,7749,8223
15,073,San Antonio la Isla,31962,15421,16541
15,074,San Felipe del Progreso,144924,69328,75596
15,075,San Mart�n de las Pir�mides,29182,14268,14914
15,076,San Mateo Atenco,97418,47481,49937
15,077,San Sim�n de Guerrero,6692,3253,3439
15,078,Santo Tom�s,9729,4836,4893
15,079,Soyaniquilpan de Ju�rez,14323,7103,7220
15,080,Sultepec,24145,11438,12707
15,081,Tec�mac,547503,265520,281983
15,082,Tejupilco,79282,38008,41274
15,083,Temamatla,14130,6928,7202
15,084,Temascalapa,43593,21374,22219
15,085,Temascalcingo,66414,31897,34517
15,086,Temascaltepec,35014,17189,17825
15,087,Temoaya,105766,51532,54234
15,088,Tenancingo,104677,51227,53450
15,089,Tenango del Aire,11359,5552,5807
15,090,Tenango del Valle,90518,44490,46028
15,091,Teoloyucan,65459,31939,33520
15,092,Teotihuac�n,58507,28195,30312
15,093,Tepetlaoxtoc,32564,15906,16658
15,094,Tepetlixpa,20500,9946,10554
15,095,Tepotzotl�n,103696,50708,52988
15,096,Tequixquiac,39489,19329,20160
15,097,Texcaltitl�n,18482,8945,9537
15,098,Texcalyacac,5736,2821,2915
15,099,Texcoco,277562,134940,142622
15,100,Tezoyuca,47044,23237,23807
15,101,Tianguistenco,84259,40847,43412
15,102,Timilpan,16414,7861,8553
15,103,Tlalmanalco,49196,23574,25622
15,104,Tlalnepantla de Baz,672202,327017,345185
15,105,Tlatlaya,31762,15626,16136
15,106,Toluca,910608,439173,471435
15,107,Tonatico,12912,6235,6677
15,108,Tultepec,157645,77132,80513
15,109,Tultitl�n,516341,251638,264703
15,110,Valle de Bravo,61590,30076,31514
15,111,Villa de Allende,53275,25894,27381
15,112,Villa del Carb�n,51498,25567,25931
15,113,Villa Guerrero,69086,33859,35227
15,114,Villa Victoria,108196,53139,55057
15,115,Xonacatl�n,54633,26758,27875
15,116,Zacazonapan,5109,2576,2533
15,117,Zacualpan,13522,6456,7066
15,118,Zinacantepec,203872,99506,104366
15,119,Zumpahuac�n,18833,9088,9745
15,120,Zumpango,280455,136971,143484
15,121,Cuautitl�n Izcalli,555163,268956,286207
15,122,Valle de Chalco Solidaridad,391731,190674,201057
15,123,Luvianos,28822,14087,14735
15,124,San Jos� del Rinc�n,100082,49033,51049
15,125,Tonanitla,14883,7253,7630
16,001,Acuitzio,11301,5493,5808
16,002,Aguililla,14754,7335,7419
16,003,�lvaro Obreg�n,23000,11224,11776
16,004,Angamacutiro,14943,7195,7748
16,005,Angangueo,10892,5274,5618
16,006,Apatzing�n,126191,62153,64038
16,007,Aporo,3529,1667,1862
16,008,Aquila,24676,12429,12247
16,009,Ario,36268,17832,18436
16,010,Arteaga,20332,10058,10274
16,011,Brise�as,11681,5670,6011
16,012,Buenavista,45538,23007,22531
16,013,Car�cuaro,9176,4611,4565
16,014,Coahuayana,17022,8724,8298
16,015,Coalcom�n de V�zquez Pallares,19633,9790,9843
16,016,Coeneo,20965,9923,11042
16,017,Contepec,35070,16944,18126
16,018,Cop�ndaro,9484,4593,4891
16,019,Cotija,20198,9780,10418
16,020,Cuitzeo,29910,14304,15606
16,021,Charapan,13539,6436,7103
16,022,Charo,25138,13622,11516
16,023,Chavinda,10417,5068,5349
16,024,Cher�n,20586,9953,10633
16,025,Chilchota,40560,19663,20897
16,026,Chinicuila,4773,2484,2289
16,027,Chuc�ndiro,4944,2387,2557
16,028,Churintzio,5233,2527,2706
16,029,Churumuco,12342,6014,6328
16,030,Ecuandureo,11850,5551,6299
16,031,Epitacio Huerta,16112,7769,8343
16,032,Erongar�cuaro,15715,7630,8085
16,033,Gabriel Zamora,21466,10591,10875
16,034,Hidalgo,125712,60614,65098
16,035,La Huacana,30627,15173,15454
16,036,Huandacareo,11644,5574,6070
16,037,Huaniqueo,7945,3738,4207
16,038,Huetamo,41973,20664,21309
16,039,Huiramba,9015,4344,4671
16,040,Indaparapeo,18385,8998,9387
16,041,Irimbo,16043,7671,8372
16,042,Ixtl�n,14302,7017,7285
16,043,Jacona,68781,33339,35442
16,044,Jim�nez,12946,6281,6665
16,045,Jiquilpan,36158,17236,18922
16,046,Ju�rez,14936,7316,7620
16,047,Jungapeo,19834,9832,10002
16,048,Lagunillas,5745,2813,2932
16,049,Madero,19086,9629,9457
16,050,Maravat�o,89311,43191,46120
16,051,Marcos Castellanos,13983,6742,7241
16,052,L�zaro C�rdenas,196003,97484,98519
16,053,Morelia,849053,407129,441924
16,054,Morelos,7983,3787,4196
16,055,M�gica,45732,22403,23329
16,056,Nahuatzen,32598,15962,16636
16,057,Nocup�taro,8196,4031,4165
16,058,Nuevo Parangaricutiro,20981,10313,10668
16,059,Nuevo Urecho,9027,4556,4471
16,060,Numar�n,9437,4596,4841
16,061,Ocampo,24774,12202,12572
16,062,Pajacuar�n,21028,10210,10818
16,063,Panind�cuaro,14889,7176,7713
16,064,Par�cuaro,26832,13472,13360
16,065,Paracho,39657,19255,20402
16,066,P�tzcuaro,98382,47220,51162
16,067,Penjamillo,16621,7860,8761
16,068,Perib�n,29389,14773,14616
16,069,La Piedad,106490,51481,55009
16,070,Pur�pero,15503,7593,7910
16,071,Puru�ndiro,69260,33311,35949
16,072,Quer�ndaro,13961,6810,7151
16,073,Quiroga,27176,12923,14253
16,074,Cojumatl�n de R�gules,10553,5321,5232
16,075,Los Reyes,78935,38758,40177
16,076,Sahuayo,78477,37897,40580
16,077,San Lucas,17677,8750,8927
16,078,Santa Ana Maya,12812,6117,6695
16,079,Salvador Escalante,49896,24402,25494
16,080,Senguio,19833,9425,10408
16,081,Susupuato,9076,4459,4617
16,082,Tac�mbaro,79540,38966,40574
16,083,Tanc�taro,33453,16736,16717
16,084,Tangamandapio,31716,15486,16230
16,085,Tanganc�cuaro,35256,17182,18074
16,086,Tanhuato,15534,7503,8031
16,087,Taretan,15589,7676,7913
16,088,Tar�mbaro,114513,55749,58764
16,089,Tepalcatepec,24074,12010,12064
16,090,Tingambato,16325,7936,8389
16,091,Ting�ind�n,14934,7175,7759
16,092,Tiquicheo de Nicol�s Romero,12836,6292,6544
16,093,Tlalpujahua,28556,13413,15143
16,094,Tlazazalca,6420,3112,3308
16,095,Tocumbo,12325,6075,6250
16,096,Tumbiscat�o,5971,3013,2958
16,097,Turicato,29056,14143,14913
16,098,Tuxpan,25757,12493,13264
16,099,Tuzantla,14329,7044,7285
16,100,Tzintzuntzan,14911,7133,7778
16,101,Tzitzio,8855,4427,4428
16,102,Uruapan,356786,172310,184476
16,103,Venustiano Carranza,23469,11241,12228
16,104,Villamar,15864,7631,8233
16,105,Vista Hermosa,20982,10359,10623
16,106,Yur�cuaro,32303,15671,16632
16,107,Zacapu,76829,36886,39943
16,108,Zamora,204860,98819,106041
16,109,Zin�paro,3232,1553,1679
16,110,Zinap�cuaro,49005,23660,25345
16,111,Ziracuaretiro,18402,9061,9341
16,112,Zit�cuaro,157056,75453,81603
16,113,Jos� Sixto Verduzco,26213,12584,13629
17,001,Amacuzac,17598,8449,9149
17,002,Atlatlahucan,25232,12266,12966
17,003,Axochiapan,39174,19288,19886
17,004,Ayala,89834,43542,46292
17,005,Coatl�n del R�o,10520,4738,5782
17,006,Cuautla,187118,89783,97335
17,007,Cuernavaca,378476,178729,199747
17,008,Emiliano Zapata,107053,52008,55045
17,009,Huitzilac,24515,11976,12539
17,010,Jantetelco,18402,8998,9404
17,011,Jiutepec,215357,103119,112238
17,012,Jojutla,57682,27820,29862
17,013,Jonacatepec de Leandro Valle,16694,8076,8618
17,014,Mazatepec,9653,4603,5050
17,015,Miacatl�n,15802,7761,8041
17,016,Ocuituco,19219,9425,9794
17,017,Puente de Ixtla,40018,19070,20948
17,018,Temixco,122263,58986,63277
17,019,Tepalcingo,28122,13841,14281
17,020,Tepoztl�n,54987,26842,28145
17,021,Tetecala,7617,3693,3924
17,022,Tetela del Volc�n,14853,7304,7549
17,023,Tlalnepantla,7943,3981,3962
17,024,Tlaltizap�n de Zapata,52399,25525,26874
17,025,Tlaquiltenango,33789,16460,17329
17,026,Tlayacapan,19408,9629,9779
17,027,Totolapan,12750,6202,6548
17,028,Xochitepec,73539,36910,36629
17,029,Yautepec,105780,51099,54681
17,030,Yecapixtla,56083,27650,28433
17,031,Zacatepec,36094,17232,18862
17,032,Zacualpan de Amilpas,9965,4857,5108
17,033,Temoac,16574,7910,8664
17,034,Coatetelco,11347,5470,5877
17,035,Xoxocotla,27805,13881,13924
17,036,Hueyapan,7855,3724,4131
18,001,Acaponeta,37232,18615,18617
18,002,Ahuacatl�n,15393,7639,7754
18,003,Amatl�n de Ca�as,11536,5868,5668
18,004,Compostela,77436,38570,38866
18,005,Huajicori,12230,6232,5998
18,006,Ixtl�n del R�o,29299,14144,15155
18,007,Jala,19321,9553,9768
18,008,Xalisco,65229,31722,33507
18,009,Del Nayar,47550,23461,24089
18,010,Rosamorada,33567,17083,16484
18,011,Ru�z,24096,12119,11977
18,012,San Blas,41518,21277,20241
18,013,San Pedro Lagunillas,7683,3922,3761
18,014,Santa Mar�a del Oro,24911,12549,12362
18,015,Santiago Ixcuintla,93981,47466,46515
18,016,Tecuala,37135,18842,18293
18,017,Tepic,425924,207092,218832
18,018,Tuxpan,30064,14972,15092
18,019,La Yesca,13719,6858,6861
18,020,Bah�a de Banderas,187632,94294,93338
19,001,Abasolo,2974,1442,1532
19,002,Agualeguas,3382,1690,1692
19,003,Los Aldamas,1407,699,708
19,004,Allende,35289,17829,17460
19,005,An�huac,18030,8852,9178
19,006,Apodaca,656464,331513,324951
19,007,Aramberri,14992,7667,7325
19,008,Bustamante,3661,1824,1837
19,009,Cadereyta Jim�nez,122337,62377,59960
19,010,El Carmen,104478,52883,51595
19,011,Cerralvo,7340,3707,3633
19,012,Ci�nega de Flores,68747,35206,33541
19,013,China,9930,4961,4969
19,014,Doctor Arroyo,36088,18060,18028
19,015,Doctor Coss,1360,657,703
19,016,Doctor Gonz�lez,3256,1672,1584
19,017,Galeana,40903,20444,20459
19,018,Garc�a,397205,200708,196497
19,019,San Pedro Garza Garc�a,132169,62586,69583
19,020,General Bravo,5506,2796,2710
19,021,General Escobedo,481213,242161,239052
19,022,General Ter�n,14109,7115,6994
19,023,General Trevi�o,1808,890,918
19,024,General Zaragoza,6282,3224,3058
19,025,General Zuazua,102149,51844,50305
19,026,Guadalupe,643143,318993,324150
19,027,Los Herreras,1959,989,970
19,028,Higueras,1386,724,662
19,029,Hualahuises,7026,3480,3546
19,030,Iturbide,3298,1716,1582
19,031,Ju�rez,471523,237717,233806
19,032,Lampazos de Naranjo,5351,2657,2694
19,033,Linares,84666,41878,42788
19,034,Mar�n,5119,2639,2480
19,035,Melchor Ocampo,1483,764,719
19,036,Mier y Noriega,7652,3795,3857
19,037,Mina,6048,3056,2992
19,038,Montemorelos,67428,33569,33859
19,039,Monterrey,1142994,564805,578189
19,040,Par�s,906,457,449
19,041,Pesquer�a,147624,76004,71620
19,042,Los Ramones,5389,2776,2613
19,043,Rayones,2377,1230,1147
19,044,Sabinas Hidalgo,34709,17035,17674
19,045,Salinas Victoria,86766,44135,42631
19,046,San Nicol�s de los Garza,412199,202958,209241
19,047,Hidalgo,16086,8082,8004
19,048,Santa Catarina,306322,152617,153705
19,049,Santiago,46784,23460,23324
19,050,Vallecillo,1552,820,732
19,051,Villaldama,3573,1787,1786
20,001,Abejones,841,360,481
20,002,Acatl�n de P�rez Figueroa,45167,21980,23187
20,003,Asunci�n Cacalotepec,2547,1229,1318
20,004,Asunci�n Cuyotepeji,1107,523,584
20,005,Asunci�n Ixtaltepec,15261,7550,7711
20,006,Asunci�n Nochixtl�n,20464,9577,10887
20,007,Asunci�n Ocotl�n,2395,1091,1304
20,008,Asunci�n Tlacolulita,734,355,379
20,009,Ayotzintepec,6857,3283,3574
20,010,El Barrio de la Soledad,13474,6502,6972
20,011,Calihual�,1402,690,712
20,012,Candelaria Loxicha,11166,5450,5716
20,013,Ci�nega de Zimatl�n,3043,1464,1579
20,014,Ciudad Ixtepec,28082,13299,14783
20,015,Coatecas Altas,5356,2527,2829
20,016,Coicoy�n de las Flores,9563,4460,5103
20,017,La Compa��a,3607,1701,1906
20,018,Concepci�n Buenavista,752,375,377
20,019,Concepci�n P�palo,2754,1376,1378
20,020,Constancia del Rosario,4847,2175,2672
20,021,Cosolapa,14488,6846,7642
20,022,Cosoltepec,803,385,418
20,023,Cuil�pam de Guerrero,26882,12863,14019
20,024,Cuyamecalco Villa de Zaragoza,3644,1847,1797
20,025,Chahuites,11356,5569,5787
20,026,Chalcatongo de Hidalgo,9035,4237,4798
20,027,Chiquihuitl�n de Benito Ju�rez,2179,994,1185
20,028,Heroica Ciudad de Ejutla de Crespo,23148,11079,12069
20,029,Eloxochitl�n de Flores Mag�n,4215,1995,2220
20,030,El Espinal,8730,4239,4491
20,031,Tamazul�pam del Esp�ritu Santo,7185,3204,3981
20,032,Fresnillo de Trujano,1077,538,539
20,033,Guadalupe Etla,2929,1397,1532
20,034,Guadalupe de Ram�rez,1288,614,674
20,035,Guelatao de Ju�rez,657,325,332
20,036,Guevea de Humboldt,5256,2485,2771
20,037,Mesones Hidalgo,4424,2051,2373
20,038,Villa Hidalgo,1885,900,985
20,039,Heroica Ciudad de Huajuapan de Le�n,78313,37162,41151
20,040,Huautepec,6385,2977,3408
20,041,Huautla de Jim�nez,31710,14628,17082
20,042,Ixtl�n de Ju�rez,8385,4036,4349
20,043,Juchit�n de Zaragoza,113570,54616,58954
20,044,Loma Bonita,40934,19493,21441
20,045,Magdalena Apasco,7888,3740,4148
20,046,Magdalena Jaltepec,2943,1339,1604
20,047,Santa Magdalena Jicotl�n,81,41,40
20,048,Magdalena Mixtepec,1433,692,741
20,049,Magdalena Ocotl�n,1184,585,599
20,050,Magdalena Pe�asco,3750,1770,1980
20,051,Magdalena Teitipac,4764,2221,2543
20,052,Magdalena Tequisistl�n,5996,2939,3057
20,053,Magdalena Tlacotepec,1297,622,675
20,054,Magdalena Zahuatl�n,404,189,215
20,055,Mariscala de Ju�rez,3739,1787,1952
20,056,M�rtires de Tacubaya,1446,710,736
20,057,Mat�as Romero Avenda�o,38183,18176,20007
20,058,Mazatl�n Villa de Flores,12722,6233,6489
20,059,Miahuatl�n de Porfirio D�az,50375,24603,25772
20,060,Mixistl�n de la Reforma,2487,1142,1345
20,061,Monjas,2893,1331,1562
20,062,Natividad,498,222,276
20,063,Nazareno Etla,4293,2056,2237
20,064,Nejapa de Madero,8494,4167,4327
20,065,Ixpantepec Nieves,1079,487,592
20,066,Santiago Niltepec,5342,2615,2727
20,067,Oaxaca de Ju�rez,270955,125852,145103
20,068,Ocotl�n de Morelos,23751,11337,12414
20,069,La Pe,3052,1515,1537
20,070,Pinotepa de Don Luis,6416,3162,3254
20,071,Pluma Hidalgo,3255,1580,1675
20,072,San Jos� del Progreso,8059,3853,4206
20,073,Putla Villa de Guerrero,34652,16189,18463
20,074,Santa Catarina Quioquitani,456,231,225
20,075,Reforma de Pineda,2660,1282,1378
20,076,La Reforma,3411,1675,1736
20,077,Reyes Etla,4370,2105,2265
20,078,Rojas de Cuauht�moc,1301,633,668
20,079,Salina Cruz,84438,40443,43995
20,080,San Agust�n Amatengo,1593,783,810
20,081,San Agust�n Atenango,1871,908,963
20,082,San Agust�n Chayuco,4163,2023,2140
20,083,San Agust�n de las Juntas,11391,5507,5884
20,084,San Agust�n Etla,4168,1984,2184
20,085,San Agust�n Loxicha,26194,12778,13416
20,086,San Agust�n Tlacotepec,1032,456,576
20,087,San Agust�n Yatareni,5521,2590,2931
20,088,San Andr�s Cabecera Nueva,2881,1395,1486
20,089,San Andr�s Dinicuiti,2308,1123,1185
20,090,San Andr�s Huaxpaltepec,6234,2994,3240
20,091,San Andr�s Huay�pam,6279,3000,3279
20,092,San Andr�s Ixtlahuaca,1776,845,931
20,093,San Andr�s Lagunas,518,247,271
20,094,San Andr�s Nuxi�o,1850,882,968
20,095,San Andr�s Paxtl�n,4562,2295,2267
20,096,San Andr�s Sinaxtla,756,354,402
20,097,San Andr�s Solaga,1771,857,914
20,098,San Andr�s Teotil�lpam,4233,1994,2239
20,099,San Andr�s Tepetlapa,381,183,198
20,100,San Andr�s Ya�,393,184,209
20,101,San Andr�s Zabache,748,337,411
20,102,San Andr�s Zautla,5326,2555,2771
20,103,San Antonino Castillo Velasco,6064,2882,3182
20,104,San Antonino el Alto,2705,1346,1359
20,105,San Antonino Monte Verde,7678,3532,4146
20,106,San Antonio Acutla,249,126,123
20,107,San Antonio de la Cal,26282,12392,13890
20,108,San Antonio Huitepec,2936,1354,1582
20,109,San Antonio Nanahuat�pam,1232,605,627
20,110,San Antonio Sinicahua,1668,740,928
20,111,San Antonio Tepetlapa,4873,2316,2557
20,112,San Baltazar Chichic�pam,2576,1225,1351
20,113,San Baltazar Loxicha,3169,1525,1644
20,114,San Baltazar Yatzachi el Bajo,674,325,349
20,115,San Bartolo Coyotepec,10391,4998,5393
20,116,San Bartolom� Ayautla,4131,1951,2180
20,117,San Bartolom� Loxicha,2213,1070,1143
20,118,San Bartolom� Quialana,2389,994,1395
20,119,San Bartolom� Yucua�e,735,325,410
20,120,San Bartolom� Zoogocho,449,242,207
20,121,San Bartolo Soyaltepec,596,289,307
20,122,San Bartolo Yautepec,653,321,332
20,123,San Bernardo Mixtepec,2829,1355,1474
20,124,San Blas Atempa,19696,9771,9925
20,125,San Carlos Yautepec,11662,5866,5796
20,126,San Crist�bal Amatl�n,5396,2578,2818
20,127,San Crist�bal Amoltepec,1252,576,676
20,128,San Crist�bal Lachirioag,1342,636,706
20,129,San Crist�bal Suchixtlahuaca,356,175,181
20,130,San Dionisio del Mar,5180,2587,2593
20,131,San Dionisio Ocotepec,11411,5413,5998
20,132,San Dionisio Ocotl�n,1380,666,714
20,133,San Esteban Atatlahuca,3934,1878,2056
20,134,San Felipe Jalapa de D�az,28500,13405,15095
20,135,San Felipe Tejal�pam,8231,3940,4291
20,136,San Felipe Usila,12191,5848,6343
20,137,San Francisco Cahuacu�,3450,1697,1753
20,138,San Francisco Cajonos,451,212,239
20,139,San Francisco Chapulapa,2195,1061,1134
20,140,San Francisco Chind�a,812,397,415
20,141,San Francisco del Mar,8710,4374,4336
20,142,San Francisco Huehuetl�n,842,378,464
20,143,San Francisco Ixhuat�n,9461,4766,4695
20,144,San Francisco Jaltepetongo,1075,514,561
20,145,San Francisco Lachigol�,5215,2502,2713
20,146,San Francisco Logueche,2803,1324,1479
20,147,San Francisco Nuxa�o,376,193,183
20,148,San Francisco Ozolotepec,2182,1040,1142
20,149,San Francisco Sola,2019,947,1072
20,150,San Francisco Telixtlahuaca,13856,6674,7182
20,151,San Francisco Teopan,312,161,151
20,152,San Francisco Tlapancingo,2472,1144,1328
20,153,San Gabriel Mixtepec,4910,2395,2515
20,154,San Ildefonso Amatl�n,2329,1079,1250
20,155,San Ildefonso Sola,1060,513,547
20,156,San Ildefonso Villa Alta,3677,1779,1898
20,157,San Jacinto Amilpas,16827,7989,8838
20,158,San Jacinto Tlacotepec,2233,1075,1158
20,159,San Jer�nimo Coatl�n,5537,2701,2836
20,160,San Jer�nimo Silacayoapilla,1429,699,730
20,161,San Jer�nimo Sosola,2730,1305,1425
20,162,San Jer�nimo Taviche,2046,987,1059
20,163,San Jer�nimo Tec�atl,1577,732,845
20,164,San Jorge Nuchita,2881,1341,1540
20,165,San Jos� Ayuquila,1629,765,864
20,166,San Jos� Chiltepec,11310,5461,5849
20,167,San Jos� del Pe�asco,2149,1022,1127
20,168,San Jos� Estancia Grande,938,457,481
20,169,San Jos� Independencia,4251,2053,2198
20,170,San Jos� Lachiguiri,3700,1752,1948
20,171,San Jos� Tenango,18102,8566,9536
20,172,San Juan Achiutla,408,203,205
20,173,San Juan Atepec,1457,705,752
20,174,�nimas Trujano,4564,2170,2394
20,175,San Juan Bautista Atatlahuca,1424,680,744
20,176,San Juan Bautista Coixtlahuaca,2725,1314,1411
20,177,San Juan Bautista Cuicatl�n,10365,5141,5224
20,178,San Juan Bautista Guelache,6692,3167,3525
20,179,San Juan Bautista Jayacatl�n,1447,703,744
20,180,San Juan Bautista Lo de Soto,2344,1177,1167
20,181,San Juan Bautista Suchitepec,453,222,231
20,182,San Juan Bautista Tlacoatzintepec,2181,1006,1175
20,183,San Juan Bautista Tlachichilco,1475,689,786
20,184,San Juan Bautista Tuxtepec,159452,75967,83485
20,185,San Juan Cacahuatepec,8939,4297,4642
20,186,San Juan Cieneguilla,524,271,253
20,187,San Juan Coatz�spam,1808,874,934
20,188,San Juan Colorado,9609,4668,4941
20,189,San Juan Comaltepec,3116,1523,1593
20,190,San Juan Cotzoc�n,22444,10843,11601
20,191,San Juan Chicomez�chil,296,133,163
20,192,San Juan Chilateca,1522,697,825
20,193,San Juan del Estado,2807,1342,1465
20,194,San Juan del R�o,1372,651,721
20,195,San Juan Diuxi,1056,497,559
20,196,San Juan Evangelista Analco,407,192,215
20,197,San Juan Guelav�a,3288,1617,1671
20,198,San Juan Guichicovi,29802,13961,15841
20,199,San Juan Ihualtepec,494,226,268
20,200,San Juan Juquila Mixes,3703,1764,1939
20,201,San Juan Juquila Vijanos,1880,884,996
20,202,San Juan Lachao,4577,2195,2382
20,203,San Juan Lachigalla,3538,1740,1798
20,204,San Juan Lajarcia,634,292,342
20,205,San Juan Lalana,16989,8244,8745
20,206,San Juan de los Cu�s,2421,1184,1237
20,207,San Juan Mazatl�n,19032,9367,9665
20,208,San Juan Mixtepec,6941,3309,3632
20,209,San Juan Mixtepec,607,245,362
20,210,San Juan �um�,5773,2618,3155
20,211,San Juan Ozolotepec,3411,1708,1703
20,212,San Juan Petlapa,3117,1484,1633
20,213,San Juan Quiahije,4203,1912,2291
20,214,San Juan Quiotepec,2033,1007,1026
20,215,San Juan Sayultepec,879,404,475
20,216,San Juan Taba�,1241,595,646
20,217,San Juan Tamazola,3325,1616,1709
20,218,San Juan Teita,544,260,284
20,219,San Juan Teitipac,2668,1276,1392
20,220,San Juan Tepeuxila,2692,1388,1304
20,221,San Juan Teposcolula,1494,723,771
20,222,San Juan Yae�,1426,687,739
20,223,San Juan Yatzona,440,197,243
20,224,San Juan Yucuita,643,305,338
20,225,San Lorenzo,5903,2802,3101
20,226,San Lorenzo Albarradas,2971,1505,1466
20,227,San Lorenzo Cacaotepec,18339,8859,9480
20,228,San Lorenzo Cuaunecuiltitla,833,431,402
20,229,San Lorenzo Texmel�can,9148,4117,5031
20,230,San Lorenzo Victoria,932,478,454
20,231,San Lucas Camotl�n,3187,1539,1648
20,232,San Lucas Ojitl�n,22185,10616,11569
20,233,San Lucas Quiavin�,1720,728,992
20,234,San Lucas Zoqui�pam,7163,3443,3720
20,235,San Luis Amatl�n,3829,1793,2036
20,236,San Marcial Ozolotepec,1372,630,742
20,237,San Marcos Arteaga,1568,734,834
20,238,San Mart�n de los Cansecos,994,472,522
20,239,San Mart�n Huamel�lpam,1000,468,532
20,240,San Mart�n Itunyoso,2749,1251,1498
20,241,San Mart�n Lachil�,1034,465,569
20,242,San Mart�n Peras,12436,5854,6582
20,243,San Mart�n Tilcajete,1975,922,1053
20,244,San Mart�n Toxpalan,3934,1891,2043
20,245,San Mart�n Zacatepec,1324,664,660
20,246,San Mateo Cajonos,611,297,314
20,247,Capul�lpam de M�ndez,1619,723,896
20,248,San Mateo del Mar,15571,7791,7780
20,249,San Mateo Yoloxochitl�n,3831,1805,2026
20,250,San Mateo Etlatongo,1239,606,633
20,251,San Mateo Nej�pam,1217,564,653
20,252,San Mateo Pe�asco,2384,1120,1264
20,253,San Mateo Pi�as,2021,1026,995
20,254,San Mateo R�o Hondo,3207,1571,1636
20,255,San Mateo Sindihui,1977,932,1045
20,256,San Mateo Tlapiltepec,229,111,118
20,257,San Melchor Betaza,1052,504,548
20,258,San Miguel Achiutla,698,350,348
20,259,San Miguel Ahuehuetitl�n,2142,1033,1109
20,260,San Miguel Alo�pam,2191,998,1193
20,261,San Miguel Amatitl�n,6932,3343,3589
20,262,San Miguel Amatl�n,991,473,518
20,263,San Miguel Coatl�n,3184,1459,1725
20,264,San Miguel Chicahua,2169,971,1198
20,265,San Miguel Chimalapa,6711,3415,3296
20,266,San Miguel del Puerto,8551,4268,4283
20,267,San Miguel del R�o,245,122,123
20,268,San Miguel Ejutla,1149,536,613
20,269,San Miguel el Grande,4313,2008,2305
20,270,San Miguel Huautla,1311,615,696
20,271,San Miguel Mixtepec,3194,1582,1612
20,272,San Miguel Panixtlahuaca,6252,2758,3494
20,273,San Miguel Peras,3818,1822,1996
20,274,San Miguel Piedras,1328,636,692
20,275,San Miguel Quetzaltepec,7286,3530,3756
20,276,San Miguel Santa Flor,691,361,330
20,277,Villa Sola de Vega,12350,5955,6395
20,278,San Miguel Soyaltepec,38682,18612,20070
20,279,San Miguel Suchixtepec,2932,1401,1531
20,280,Villa Talea de Castro,2011,945,1066
20,281,San Miguel Tecomatl�n,305,152,153
20,282,San Miguel Tenango,653,334,319
20,283,San Miguel Tequixtepec,1044,496,548
20,284,San Miguel Tilqui�pam,3141,1415,1726
20,285,San Miguel Tlacamama,3668,1786,1882
20,286,San Miguel Tlacotepec,3100,1432,1668
20,287,San Miguel Tulancingo,307,134,173
20,288,San Miguel Yotao,585,272,313
20,289,San Nicol�s,1214,580,634
20,290,San Nicol�s Hidalgo,1043,499,544
20,291,San Pablo Coatl�n,4308,2107,2201
20,292,San Pablo Cuatro Venados,1510,718,792
20,293,San Pablo Etla,17116,8033,9083
20,294,San Pablo Huitzo,7035,3318,3717
20,295,San Pablo Huixtepec,10020,4721,5299
20,296,San Pablo Macuiltianguis,955,478,477
20,297,San Pablo Tijaltepec,2751,1277,1474
20,298,San Pablo Villa de Mitla,13587,6526,7061
20,299,San Pablo Yaganiza,1125,543,582
20,300,San Pedro Amuzgos,6632,3080,3552
20,301,San Pedro Ap�stol,1594,747,847
20,302,San Pedro Atoyac,4559,2113,2446
20,303,San Pedro Cajonos,1081,495,586
20,304,San Pedro Coxcaltepec C�ntaros,716,334,382
20,305,San Pedro Comitancillo,4333,2065,2268
20,306,San Pedro el Alto,4654,2256,2398
20,307,San Pedro Huamelula,9735,4802,4933
20,308,San Pedro Huilotepec,3307,1623,1684
20,309,San Pedro Ixcatl�n,10368,4976,5392
20,310,San Pedro Ixtlahuaca,14552,7118,7434
20,311,San Pedro Jaltepetongo,483,231,252
20,312,San Pedro Jicay�n,11279,5272,6007
20,313,San Pedro Jocotipac,730,341,389
20,314,San Pedro Juchatengo,1755,842,913
20,315,San Pedro M�rtir,1899,867,1032
20,316,San Pedro M�rtir Quiechapa,738,346,392
20,317,San Pedro M�rtir Yucuxaco,1257,599,658
20,318,San Pedro Mixtepec,49780,24008,25772
20,319,San Pedro Mixtepec,972,468,504
20,320,San Pedro Molinos,706,339,367
20,321,San Pedro Nopala,751,358,393
20,322,San Pedro Ocopetatillo,786,348,438
20,323,San Pedro Ocotepec,2404,1196,1208
20,324,San Pedro Pochutla,48204,23519,24685
20,325,San Pedro Quiatoni,11930,5781,6149
20,326,San Pedro Sochi�pam,5052,2438,2614
20,327,San Pedro Tapanatepec,15479,7614,7865
20,328,San Pedro Taviche,1441,691,750
20,329,San Pedro Teozacoalco,1153,575,578
20,330,San Pedro Teutila,4296,2100,2196
20,331,San Pedro Tida�,982,451,531
20,332,San Pedro Topiltepec,373,183,190
20,333,San Pedro Totol�pam,3294,1637,1657
20,334,Villa de Tututepec,50541,24533,26008
20,335,San Pedro Yaneri,867,418,449
20,336,San Pedro Y�lox,1697,819,878
20,337,San Pedro y San Pablo Ayutla,5616,2533,3083
20,338,Villa de Etla,10361,4992,5369
20,339,San Pedro y San Pablo Teposcolula,4353,2054,2299
20,340,San Pedro y San Pablo Tequixtepec,1747,800,947
20,341,San Pedro Yucunama,241,109,132
20,342,San Raymundo Jalpan,4105,1919,2186
20,343,San Sebasti�n Abasolo,1999,948,1051
20,344,San Sebasti�n Coatl�n,2809,1359,1450
20,345,San Sebasti�n Ixcapa,4188,2034,2154
20,346,San Sebasti�n Nicananduta,1542,704,838
20,347,San Sebasti�n R�o Hondo,4202,2100,2102
20,348,San Sebasti�n Tecomaxtlahuaca,8192,3909,4283
20,349,San Sebasti�n Teitipac,2189,1007,1182
20,350,San Sebasti�n Tutla,16878,7706,9172
20,351,San Sim�n Almolongas,2802,1333,1469
20,352,San Sim�n Zahuatl�n,4940,2469,2471
20,353,Santa Ana,2406,1188,1218
20,354,Santa Ana Ateixtlahuaca,477,238,239
20,355,Santa Ana Cuauht�moc,681,342,339
20,356,Santa Ana del Valle,2179,1076,1103
20,357,Santa Ana Tavela,848,409,439
20,358,Santa Ana Tlapacoyan,1958,925,1033
20,359,Santa Ana Yareni,637,281,356
20,360,Santa Ana Zegache,3981,1863,2118
20,361,Santa Catalina Quier�,825,366,459
20,362,Santa Catarina Cuixtla,1495,675,820
20,363,Santa Catarina Ixtepeji,2675,1262,1413
20,364,Santa Catarina Juquila,18654,8981,9673
20,365,Santa Catarina Lachatao,1059,485,574
20,366,Santa Catarina Loxicha,3676,1729,1947
20,367,Santa Catarina Mechoac�n,4582,2238,2344
20,368,Santa Catarina Minas,2067,1028,1039
20,369,Santa Catarina Quian�,2193,1069,1124
20,370,Santa Catarina Tayata,662,316,346
20,371,Santa Catarina Ticu�,986,428,558
20,372,Santa Catarina Yosonot�,1316,591,725
20,373,Santa Catarina Zapoquila,403,201,202
20,374,Santa Cruz Acatepec,1645,773,872
20,375,Santa Cruz Amilpas,13200,6190,7010
20,376,Santa Cruz de Bravo,365,170,195
20,377,Santa Cruz Itundujia,10860,5180,5680
20,378,Santa Cruz Mixtepec,3720,1792,1928
20,379,Santa Cruz Nundaco,2951,1327,1624
20,380,Santa Cruz Papalutla,2242,1094,1148
20,381,Santa Cruz Tacache de Mina,2940,1388,1552
20,382,Santa Cruz Tacahua,1182,561,621
20,383,Santa Cruz Tayata,595,293,302
20,384,Santa Cruz Xitla,4794,2281,2513
20,385,Santa Cruz Xoxocotl�n,100402,47016,53386
20,386,Santa Cruz Zenzontepec,19079,9243,9836
20,387,Santa Gertrudis,2891,1386,1505
20,388,Santa In�s del Monte,2809,1390,1419
20,389,Santa In�s Yatzeche,908,422,486
20,390,Santa Luc�a del Camino,50362,24171,26191
20,391,Santa Luc�a Miahuatl�n,3375,1647,1728
20,392,Santa Luc�a Monteverde,6726,3232,3494
20,393,Santa Luc�a Ocotl�n,4173,1971,2202
20,394,Santa Mar�a Alotepec,2796,1353,1443
20,395,Santa Mar�a Apazco,1629,740,889
20,396,Santa Mar�a la Asunci�n,3259,1432,1827
20,397,Heroica Ciudad de Tlaxiaco,40123,18602,21521
20,398,Ayoquezco de Aldama,4874,2360,2514
20,399,Santa Mar�a Atzompa,41921,19948,21973
20,400,Santa Mar�a Camotl�n,1713,821,892
20,401,Santa Mar�a Colotepec,27046,13241,13805
20,402,Santa Mar�a Cortijo,1067,518,549
20,403,Santa Mar�a Coyotepec,3751,1768,1983
20,404,Santa Mar�a Chacho�pam,761,367,394
20,405,Villa de Chilapa de D�az,1815,829,986
20,406,Santa Mar�a Chilchotla,21469,10373,11096
20,407,Santa Mar�a Chimalapa,9578,4790,4788
20,408,Santa Mar�a del Rosario,499,246,253
20,409,Santa Mar�a del Tule,8939,4139,4800
20,410,Santa Mar�a Ecatepec,3418,1734,1684
20,411,Santa Mar�a Guelac�,908,429,479
20,412,Santa Mar�a Guienagati,3178,1554,1624
20,413,Santa Mar�a Huatulco,50862,24854,26008
20,414,Santa Mar�a Huazolotitl�n,11995,5890,6105
20,415,Santa Mar�a Ipalapa,4878,2302,2576
20,416,Santa Mar�a Ixcatl�n,461,224,237
20,417,Santa Mar�a Jacatepec,9682,4588,5094
20,418,Santa Mar�a Jalapa del Marqu�s,11735,5660,6075
20,419,Santa Mar�a Jaltianguis,592,278,314
20,420,Santa Mar�a Lachix�o,1679,760,919
20,421,Santa Mar�a Mixtequilla,4690,2278,2412
20,422,Santa Mar�a Nativitas,603,276,327
20,423,Santa Mar�a Nduayaco,453,219,234
20,424,Santa Mar�a Ozolotepec,3793,1835,1958
20,425,Santa Mar�a P�palo,2058,1028,1030
20,426,Santa Mar�a Pe�oles,8967,4323,4644
20,427,Santa Mar�a Petapa,16706,8080,8626
20,428,Santa Mar�a Quiegolani,2224,1134,1090
20,429,Santa Mar�a Sola,1516,736,780
20,430,Santa Mar�a Tataltepec,317,154,163
20,431,Santa Mar�a Tecomavaca,1830,891,939
20,432,Santa Mar�a Temaxcalapa,903,443,460
20,433,Santa Mar�a Temaxcaltepec,2694,1222,1472
20,434,Santa Mar�a Teopoxco,3985,1790,2195
20,435,Santa Mar�a Tepantlali,3576,1737,1839
20,436,Santa Mar�a Texcatitl�n,896,432,464
20,437,Santa Mar�a Tlahuitoltepec,9653,4575,5078
20,438,Santa Mar�a Tlalixtac,1839,924,915
20,439,Santa Mar�a Tonameca,25347,12364,12983
20,440,Santa Mar�a Totolapilla,812,396,416
20,441,Santa Mar�a Xadani,9234,4560,4674
20,442,Santa Mar�a Yalina,250,112,138
20,443,Santa Mar�a Yaves�a,434,199,235
20,444,Santa Mar�a Yolotepec,481,226,255
20,445,Santa Mar�a Yosoy�a,1699,813,886
20,446,Santa Mar�a Yucuhiti,6008,2850,3158
20,447,Santa Mar�a Zacatepec,17100,8146,8954
20,448,Santa Mar�a Zaniza,2469,1190,1279
20,449,Santa Mar�a Zoquitl�n,3294,1630,1664
20,450,Santiago Amoltepec,13855,6785,7070
20,451,Santiago Apoala,1019,469,550
20,452,Santiago Ap�stol,4421,2006,2415
20,453,Santiago Astata,3918,1948,1970
20,454,Santiago Atitl�n,3556,1783,1773
20,455,Santiago Ayuquililla,2904,1407,1497
20,456,Santiago Cacaloxtepec,1667,802,865
20,457,Santiago Camotl�n,3346,1631,1715
20,458,Santiago Comaltepec,1157,540,617
20,459,Villa de Santiago Chazumba,4877,2296,2581
20,460,Santiago Cho�pam,5242,2491,2751
20,461,Santiago del R�o,527,251,276
20,462,Santiago Huajolotitl�n,4600,2213,2387
20,463,Santiago Huauclilla,525,245,280
20,464,Santiago Ihuitl�n Plumas,341,155,186
20,465,Santiago Ixcuintepec,1636,775,861
20,466,Santiago Ixtayutla,13880,6551,7329
20,467,Santiago Jamiltepec,19112,9159,9953
20,468,Santiago Jocotepec,14198,6863,7335
20,469,Santiago Juxtlahuaca,34735,16527,18208
20,470,Santiago Lachiguiri,4394,2135,2259
20,471,Santiago Lalopa,431,203,228
20,472,Santiago Laollaga,3361,1629,1732
20,473,Santiago Laxopa,1291,595,696
20,474,Santiago Llano Grande,3440,1716,1724
20,475,Santiago Matatl�n,10175,4714,5461
20,476,Santiago Miltepec,421,210,211
20,477,Santiago Minas,1327,652,675
20,478,Santiago Nacaltepec,1599,735,864
20,479,Santiago Nejapilla,174,84,90
20,480,Santiago Nundiche,1351,644,707
20,481,Santiago Nuyo�,1898,910,988
20,482,Santiago Pinotepa Nacional,55840,27214,28626
20,483,Santiago Suchilquitongo,10886,5244,5642
20,484,Santiago Tamazola,4458,2102,2356
20,485,Santiago Tapextla,3134,1582,1552
20,486,Villa Tej�pam de la Uni�n,2419,1160,1259
20,487,Santiago Tenango,1966,969,997
20,488,Santiago Tepetlapa,130,52,78
20,489,Santiago Tetepec,4909,2378,2531
20,490,Santiago Texcalcingo,2974,1405,1569
20,491,Santiago Textitl�n,4930,2420,2510
20,492,Santiago Tilantongo,2764,1274,1490
20,493,Santiago Tillo,545,259,286
20,494,Santiago Tlazoyaltepec,6300,2906,3394
20,495,Santiago Xanica,3029,1538,1491
20,496,Santiago Xiacu�,1893,906,987
20,497,Santiago Yaitepec,4233,1906,2327
20,498,Santiago Yaveo,7593,3787,3806
20,499,Santiago Yolom�catl,1922,884,1038
20,500,Santiago Yosond�a,7991,3753,4238
20,501,Santiago Yucuyachi,998,493,505
20,502,Santiago Zacatepec,5089,2479,2610
20,503,Santiago Zoochila,425,206,219
20,504,Nuevo Zoqui�pam,1590,762,828
20,505,Santo Domingo Ingenio,7681,3765,3916
20,506,Santo Domingo Albarradas,798,377,421
20,507,Santo Domingo Armenta,3155,1582,1573
20,508,Santo Domingo Chihuit�n,1618,793,825
20,509,Santo Domingo de Morelos,11384,5470,5914
20,510,Santo Domingo Ixcatl�n,760,345,415
20,511,Santo Domingo Nuxa�,3335,1626,1709
20,512,Santo Domingo Ozolotepec,1101,525,576
20,513,Santo Domingo Petapa,9027,4502,4525
20,514,Santo Domingo Roayaga,941,450,491
20,515,Santo Domingo Tehuantepec,67739,32825,34914
20,516,Santo Domingo Teojomulco,5260,2576,2684
20,517,Santo Domingo Tepuxtepec,6029,2796,3233
20,518,Santo Domingo Tlatay�pam,113,52,61
20,519,Santo Domingo Tomaltepec,3386,1651,1735
20,520,Santo Domingo Tonal�,7393,3567,3826
20,521,Santo Domingo Tonaltepec,250,117,133
20,522,Santo Domingo Xagac�a,1205,554,651
20,523,Santo Domingo Yanhuitl�n,1633,759,874
20,524,Santo Domingo Yodohino,327,171,156
20,525,Santo Domingo Zanatepec,12483,6150,6333
20,526,Santos Reyes Nopala,16688,7897,8791
20,527,Santos Reyes P�palo,2490,1218,1272
20,528,Santos Reyes Tepejillo,904,414,490
20,529,Santos Reyes Yucun�,1474,731,743
20,530,Santo Tom�s Jalieza,3923,1858,2065
20,531,Santo Tom�s Mazaltepec,2612,1263,1349
20,532,Santo Tom�s Ocotepec,4066,1857,2209
20,533,Santo Tom�s Tamazulapan,2726,1308,1418
20,534,San Vicente Coatl�n,3512,1617,1895
20,535,San Vicente Lachix�o,3227,1460,1767
20,536,San Vicente Nu��,449,211,238
20,537,Silacayo�pam,6710,3227,3483
20,538,Sitio de Xitlapehua,713,349,364
20,539,Soledad Etla,6348,3077,3271
20,540,Villa de Tamazul�pam del Progreso,8326,3756,4570
20,541,Tanetze de Zaragoza,1558,746,812
20,542,Taniche,887,413,474
20,543,Tataltepec de Vald�s,6386,3112,3274
20,544,Teococuilco de Marcos P�rez,1032,499,533
20,545,Teotitl�n de Flores Mag�n,10099,4786,5313
20,546,Teotitl�n del Valle,6392,3037,3355
20,547,Teotongo,1005,457,548
20,548,Tepelmeme Villa de Morelos,1960,916,1044
20,549,"Heroica Villa Tezoatl�n de Segura y Luna, Cuna de la Independencia de Oaxaca",11465,5396,6069
20,550,San Jer�nimo Tlacochahuaya,5764,2712,3052
20,551,Tlacolula de Matamoros,30254,14385,15869
20,552,Tlacotepec Plumas,410,198,212
20,553,Tlalixtac de Cabrera,12067,5772,6295
20,554,Totontepec Villa de Morelos,5904,2841,3063
20,555,Trinidad Zaachila,3419,1607,1812
20,556,La Trinidad Vista Hermosa,306,151,155
20,557,Uni�n Hidalgo,14542,7077,7465
20,558,Valerio Trujano,1376,640,736
20,559,San Juan Bautista Valle Nacional,23067,10986,12081
20,560,Villa D�az Ordaz,6467,2964,3503
20,561,Yaxe,2954,1430,1524
20,562,Magdalena Yodocono de Porfirio D�az,1682,813,869
20,563,Yogana,1245,596,649
20,564,Yutanduchi de Guerrero,1195,577,618
20,565,Villa de Zaachila,46464,22163,24301
20,566,San Mateo Yucutindoo,3144,1586,1558
20,567,Zapotitl�n Lagunas,3382,1637,1745
20,568,Zapotitl�n Palmas,1695,765,930
20,569,Santa In�s de Zaragoza,1454,694,760
20,570,Zimatl�n de �lvarez,22093,10430,11663
21,001,Acajete,72894,35139,37755
21,002,Acateno,9170,4586,4584
21,003,Acatl�n,37955,17836,20119
21,004,Acatzingo,63743,30923,32820
21,005,Acteopan,3070,1446,1624
21,006,Ahuacatl�n,14542,6852,7690
21,007,Ahuatl�n,3162,1557,1605
21,008,Ahuazotepec,11439,5549,5890
21,009,Ahuehuetitla,2207,1053,1154
21,010,Ajalpan,74768,36191,38577
21,011,Albino Zertuche,1885,886,999
21,012,Aljojuca,6591,3100,3491
21,013,Altepexi,22629,10889,11740
21,014,Amixtl�n,4812,2270,2542
21,015,Amozoc,125876,61479,64397
21,016,Aquixtla,9021,4508,4513
21,017,Atempan,29742,14279,15463
21,018,Atexcal,3859,1841,2018
21,019,Atlixco,141793,66862,74931
21,020,Atoyatempan,7704,3760,3944
21,021,Atzala,1512,729,783
21,022,Atzitzihuac�n,12857,6025,6832
21,023,Atzitzintla,9051,4421,4630
21,024,Axutla,976,466,510
21,025,Ayotoxco de Guerrero,8208,3968,4240
21,026,Calpan,15271,7337,7934
21,027,Caltepec,4128,1923,2205
21,028,Camocuautla,2758,1367,1391
21,029,Caxhuacan,3811,1816,1995
21,030,Coatepec,772,372,400
21,031,Coatzingo,2820,1363,1457
21,032,Cohetzala,1382,719,663
21,033,Cohuecan,5403,2549,2854
21,034,Coronango,46836,22984,23852
21,035,Coxcatl�n,20653,9775,10878
21,036,Coyomeapan,14806,6943,7863
21,037,Coyotepec,2334,1099,1235
21,038,Cuapiaxtla de Madero,10542,5196,5346
21,039,Cuautempan,9837,4659,5178
21,040,Cuautinch�n,12340,6104,6236
21,041,Cuautlancingo,137435,66950,70485
21,042,Cuayuca de Andrade,3315,1629,1686
21,043,Cuetzalan del Progreso,49864,24149,25715
21,044,Cuyoaco,17139,8226,8913
21,045,Chalchicomula de Sesma,47410,22788,24622
21,046,Chapulco,8193,3937,4256
21,047,Chiautla,21699,10672,11027
21,048,Chiautzingo,22039,10496,11543
21,049,Chiconcuautla,17382,8464,8918
21,050,Chichiquila,26928,13303,13625
21,051,Chietla,37030,17989,19041
21,052,Chigmecatitl�n,1215,536,679
21,053,Chignahuapan,66464,32162,34302
21,054,Chignautla,35223,16932,18291
21,055,Chila,5082,2418,2664
21,056,Chila de la Sal,1317,635,682
21,057,Honey,6687,3205,3482
21,058,Chilchotla,21002,10407,10595
21,059,Chinantla,2846,1382,1464
21,060,Domingo Arenas,7982,3832,4150
21,061,Eloxochitl�n,14461,7070,7391
21,062,Epatl�n,4943,2421,2522
21,063,Esperanza,14766,7091,7675
21,064,Francisco Z. Mena,17824,8867,8957
21,065,General Felipe �ngeles,22694,10982,11712
21,066,Guadalupe,6451,3013,3438
21,067,Guadalupe Victoria,18784,9209,9575
21,068,Hermenegildo Galeana,7011,3378,3633
21,069,Huaquechula,29233,13800,15433
21,070,Huatlatlauca,6111,2784,3327
21,071,Huauchinango,103946,48818,55128
21,072,Huehuetla,17082,8373,8709
21,073,Huehuetl�n el Chico,9760,4792,4968
21,074,Huejotzingo,90794,44075,46719
21,075,Hueyapan,13080,6259,6821
21,076,Hueytamalco,27600,13597,14003
21,077,Hueytlalpan,5951,2924,3027
21,078,Huitzilan de Serd�n,15928,8092,7836
21,079,Huitziltepec,5782,2797,2985
21,080,Atlequizayan,2633,1228,1405
21,081,Ixcamilpa de Guerrero,4065,1948,2117
21,082,Ixcaquixtla,8804,4193,4611
21,083,Ixtacamaxtitl�n,25319,12488,12831
21,084,Ixtepec,6950,3370,3580
21,085,Iz�car de Matamoros,82809,39551,43258
21,086,Jalpan,12050,5717,6333
21,087,Jolalpan,13308,6418,6890
21,088,Jonotla,4457,2172,2285
21,089,Jopala,12131,5817,6314
21,090,Juan C. Bonilla,23783,11475,12308
21,091,Juan Galindo,9828,4559,5269
21,092,Juan N. M�ndez,5293,2555,2738
21,093,Lafragua,7650,3709,3941
21,094,Libres,37257,18097,19160
21,095,La Magdalena Tlatlauquitepec,650,324,326
21,096,Mazapiltepec de Ju�rez,3176,1557,1619
21,097,Mixtla,2668,1270,1398
21,098,Molcaxac,6668,3173,3495
21,099,Ca�ada Morelos,20659,9911,10748
21,100,Naupan,9310,4320,4990
21,101,Nauzontla,3317,1543,1774
21,102,Nealtican,14075,6815,7260
21,103,Nicol�s Bravo,6644,3230,3414
21,104,Nopalucan,32772,15891,16881
21,105,Ocotepec,5077,2433,2644
21,106,Ocoyucan,42669,20420,22249
21,107,Olintla,11993,5835,6158
21,108,Oriental,19903,9678,10225
21,109,Pahuatl�n,20274,9674,10600
21,110,Palmar de Bravo,50226,24595,25631
21,111,Pantepec,18528,8904,9624
21,112,Petlalcingo,9350,4489,4861
21,113,Piaxtla,4627,2262,2365
21,114,Puebla,1692181,809485,882696
21,115,Quecholac,57992,28367,29625
21,116,Quimixtl�n,22855,11102,11753
21,117,Rafael Lara Grajales,15952,7625,8327
21,118,Los Reyes de Ju�rez,30021,14606,15415
21,119,San Andr�s Cholula,154448,74272,80176
21,120,San Antonio Ca�ada,5938,2791,3147
21,121,San Diego la Mesa Tochimiltzingo,1270,626,644
21,122,San Felipe Teotlalcingo,11063,5349,5714
21,123,San Felipe Tepatl�n,3793,1829,1964
21,124,San Gabriel Chilac,15954,7569,8385
21,125,San Gregorio Atzompa,9671,4682,4989
21,126,San Jer�nimo Tecuanipan,6597,3118,3479
21,127,San Jer�nimo Xayacatl�n,3606,1734,1872
21,128,San Jos� Chiapa,10443,5107,5336
21,129,San Jos� Miahuatl�n,14018,6720,7298
21,130,San Juan Atenco,3604,1660,1944
21,131,San Juan Atzompa,975,508,467
21,132,San Mart�n Texmelucan,155738,74922,80816
21,133,San Mart�n Totoltepec,692,358,334
21,134,San Mat�as Tlalancaleca,20974,10218,10756
21,135,San Miguel Ixitl�n,526,254,272
21,136,San Miguel Xoxtla,12461,6089,6372
21,137,San Nicol�s Buenos Aires,10464,5120,5344
21,138,San Nicol�s de los Ranchos,11780,5737,6043
21,139,San Pablo Anicano,3759,1791,1968
21,140,San Pedro Cholula,138433,66454,71979
21,141,San Pedro Yeloixtlahuaca,3488,1685,1803
21,142,San Salvador el Seco,30639,14990,15649
21,143,San Salvador el Verde,34880,16955,17925
21,144,San Salvador Huixcolotla,16790,8176,8614
21,145,San Sebasti�n Tlacotepec,13189,6486,6703
21,146,Santa Catarina Tlaltempan,749,372,377
21,147,Santa In�s Ahuatempan,6341,3038,3303
21,148,Santa Isabel Cholula,11498,5613,5885
21,149,Santiago Miahuatl�n,30309,14673,15636
21,150,Huehuetl�n el Grande,6105,2946,3159
21,151,Santo Tom�s Hueyotlipan,9315,4524,4791
21,152,Soltepec,12631,6103,6528
21,153,Tecali de Herrera,23625,11494,12131
21,154,Tecamachalco,80771,38781,41990
21,155,Tecomatl�n,6830,3416,3414
21,156,Tehuac�n,327312,154407,172905
21,157,Tehuitzingo,12672,6093,6579
21,158,Tenampulco,6743,3304,3439
21,159,Teopantl�n,3836,1712,2124
21,160,Teotlalco,3689,1840,1849
21,161,Tepanco de L�pez,22218,10401,11817
21,162,Tepango de Rodr�guez,4155,1919,2236
21,163,Tepatlaxco de Hidalgo,18854,9120,9734
21,164,Tepeaca,84270,40509,43761
21,165,Tepemaxalco,1216,614,602
21,166,Tepeojuma,8918,4139,4779
21,167,Tepetzintla,10373,4915,5458
21,168,Tepexco,7523,3704,3819
21,169,Tepexi de Rodr�guez,22331,11194,11137
21,170,Tepeyahualco,19200,9366,9834
21,171,Tepeyahualco de Cuauht�moc,3851,1816,2035
21,172,Tetela de Ocampo,27216,13100,14116
21,173,Teteles de �vila Castillo,6653,2887,3766
21,174,Teziutl�n,103583,48649,54934
21,175,Tianguismanalco,14432,6990,7442
21,176,Tilapa,9664,4635,5029
21,177,Tlacotepec de Benito Ju�rez,54757,25754,29003
21,178,Tlacuilotepec,15977,7876,8101
21,179,Tlachichuca,31639,15498,16141
21,180,Tlahuapan,41547,20461,21086
21,181,Tlaltenango,7425,3634,3791
21,182,Tlanepantla,5390,2582,2808
21,183,Tlaola,20433,9850,10583
21,184,Tlapacoya,6422,3075,3347
21,185,Tlapanal�,10344,5050,5294
21,186,Tlatlauquitepec,55576,26617,28959
21,187,Tlaxco,4934,2428,2506
21,188,Tochimilco,19315,9196,10119
21,189,Tochtepec,22454,10828,11626
21,190,Totoltepec de Guerrero,1187,553,634
21,191,Tulcingo,9871,4641,5230
21,192,Tuzamapan de Galeana,5924,2909,3015
21,193,Tzicatlacoyan,6476,3190,3286
21,194,Venustiano Carranza,28395,13413,14982
21,195,Vicente Guerrero,26559,12434,14125
21,196,Xayacatl�n de Bravo,1570,726,844
21,197,Xicotepec,80591,38448,42143
21,198,Xicotl�n,1312,628,684
21,199,Xiutetelco,42943,20679,22264
21,200,Xochiapulco,3443,1625,1818
21,201,Xochiltepec,3375,1568,1807
21,202,Xochitl�n de Vicente Su�rez,13025,6262,6763
21,203,Xochitl�n Todos Santos,7178,3407,3771
21,204,Yaon�huac,7926,3683,4243
21,205,Yehualtepec,26392,12709,13683
21,206,Zacapala,4647,2205,2442
21,207,Zacapoaxtla,57887,27151,30736
21,208,Zacatl�n,87361,41505,45856
21,209,Zapotitl�n,8595,3985,4610
21,210,Zapotitl�n de M�ndez,5675,2793,2882
21,211,Zaragoza,16752,7754,8998
21,212,Zautla,20717,9828,10889
21,213,Zihuateutla,11967,5774,6193
21,214,Zinacatepec,18359,8781,9578
21,215,Zongozotla,4539,2217,2322
21,216,Zoquiapan,2452,1138,1314
21,217,Zoquitl�n,20335,9705,10630
22,001,Amealco de Bonfil,66841,32235,34606
22,002,Pinal de Amoles,27365,13293,14072
22,003,Arroyo Seco,13142,6270,6872
22,004,Cadereyta de Montes,69075,32993,36082
22,005,Col�n,67121,33211,33910
22,006,Corregidora,212567,103032,109535
22,007,Ezequiel Montes,45141,21692,23449
22,008,Huimilpan,36808,17345,19463
22,009,Jalpan de Serra,27343,13036,14307
22,010,Landa de Matamoros,18794,8988,9806
22,011,El Marqu�s,231668,115483,116185
22,012,Pedro Escobedo,77404,37925,39479
22,013,Pe�amiller,19141,9352,9789
22,014,Quer�taro,1049777,514589,535188
22,015,San Joaqu�n,8359,3875,4484
22,016,San Juan del R�o,297804,145350,152454
22,017,Tequisquiapan,72201,35023,37178
22,018,Tolim�n,27916,13128,14788
23,001,Cozumel,88626,44415,44211
23,002,Felipe Carrillo Puerto,83990,41954,42036
23,003,Isla Mujeres,22686,11542,11144
23,004,Oth�n P. Blanco,233648,115096,118552
23,005,Benito Ju�rez,911503,459325,452178
23,006,Jos� Mar�a Morelos,39165,19855,19310
23,007,L�zaro C�rdenas,29171,14844,14327
23,008,Solidaridad,333800,170476,163324
23,009,Tulum,46721,24390,22331
23,010,Bacalar,41754,21051,20703
23,011,Puerto Morelos,26921,13831,13090
24,001,Ahualulco,18974,8945,10029
24,002,Alaquines,7785,3787,3998
24,003,Aquism�n,48359,24013,24346
24,004,Armadillo de los Infante,4013,1997,2016
24,005,C�rdenas,18317,8735,9582
24,006,Catorce,9579,4890,4689
24,007,Cedral,19840,9676,10164
24,008,Cerritos,22075,10782,11293
24,009,Cerro de San Pedro,5050,2553,2497
24,010,Ciudad del Ma�z,30320,14995,15325
24,011,Ciudad Fern�ndez,48106,23443,24663
24,012,Tancanhuitz,20300,10001,10299
24,013,Ciudad Valles,179371,86362,93009
24,014,Coxcatl�n,15660,7763,7897
24,015,Charcas,21814,10656,11158
24,016,Ebano,40899,19931,20968
24,017,Guadalc�zar,25119,12511,12608
24,018,Huehuetl�n,15334,7482,7852
24,019,Lagunillas,5453,2730,2723
24,020,Matehuala,102199,49651,52548
24,021,Mexquitic de Carmona,58469,27871,30598
24,022,Moctezuma,19036,9081,9955
24,023,Ray�n,15301,7458,7843
24,024,Rioverde,97943,47043,50900
24,025,Salinas,31107,14874,16233
24,026,San Antonio,9382,4704,4678
24,027,San Ciro de Acosta,10215,4941,5274
24,028,San Luis Potos�,911908,440897,471011
24,029,San Mart�n Chalchicuautla,18468,9107,9361
24,030,San Nicol�s Tolentino,4779,2371,2408
24,031,Santa Catarina,12163,5917,6246
24,032,Santa Mar�a del R�o,39880,19158,20722
24,033,Santo Domingo,10785,5279,5506
24,034,San Vicente Tancuayalab,14945,7411,7534
24,035,Soledad de Graciano S�nchez,332072,161877,170195
24,036,Tamasopo,29184,14746,14438
24,037,Tamazunchale,95037,46209,48828
24,038,Tampac�n,14348,7281,7067
24,039,Tampamol�n Corona,13603,6755,6848
24,040,Tamu�n,36968,18109,18859
24,041,Tanlaj�s,18208,9111,9097
24,042,Tanqui�n de Escobedo,13448,6573,6875
24,043,Tierra Nueva,7966,3720,4246
24,044,Vanegas,7557,3806,3751
24,045,Venado,14188,7016,7172
24,046,Villa de Arriaga,18206,8993,9213
24,047,Villa de Guadalupe,9277,4631,4646
24,048,Villa de la Paz,5298,2634,2664
24,049,Villa de Ramos,38389,18267,20122
24,050,Villa de Reyes,52912,26163,26749
24,051,Villa Hidalgo,15458,7655,7803
24,052,Villa Ju�rez,10304,5135,5169
24,053,Axtla de Terrazas,32544,15917,16627
24,054,Xilitla,49741,24430,25311
24,055,Zaragoza,27386,13482,13904
24,056,Villa de Arista,17258,8370,8888
24,057,Matlapa,28996,14111,14885
24,058,El Naranjo,20959,10445,10514
25,001,Ahome,459310,225316,233994
25,002,Angostura,44093,22129,21964
25,003,Badiraguato,26542,13669,12873
25,004,Concordia,24899,12539,12360
25,005,Cosal�,17012,8676,8336
25,006,Culiac�n,1003530,491046,512484
25,007,Choix,29334,14889,14445
25,008,Elota,55339,28546,26793
25,009,Escuinapa,59988,30101,29887
25,010,El Fuerte,96593,48456,48137
25,011,Guasave,289370,143018,146352
25,012,Mazatl�n,501441,245381,256060
25,013,Mocorito,40358,20575,19783
25,014,Rosario,52345,26449,25896
25,015,Salvador Alvarado,79492,38424,41068
25,016,San Ignacio,19505,10282,9223
25,017,Sinaloa,78670,39850,38820
25,018,Navolato,149122,75469,73653
26,001,Aconchi,2563,1336,1227
26,002,Agua Prieta,91929,45811,46118
26,003,�lamos,24976,12909,12067
26,004,Altar,9492,4712,4780
26,005,Arivechi,1177,594,583
26,006,Arizpe,2788,1446,1342
26,007,Atil,626,310,316
26,008,Bacad�huachi,979,522,457
26,009,Bacanora,759,390,369
26,010,Bacerac,1221,603,618
26,011,Bacoachi,1475,750,725
26,012,B�cum,23151,11784,11367
26,013,Ban�michi,1825,924,901
26,014,Bavi�cora,3191,1662,1529
26,015,Bavispe,1169,618,551
26,016,Benjam�n Hill,4988,2483,2505
26,017,Caborca,89122,44736,44386
26,018,Cajeme,436484,214601,221883
26,019,Cananea,39451,19610,19841
26,020,Carb�,4946,2568,2378
26,021,La Colorada,1848,1020,828
26,022,Cucurpe,863,470,393
26,023,Cumpas,5829,2965,2864
26,024,Divisaderos,753,394,359
26,025,Empalme,51431,25968,25463
26,026,Etchojoa,61309,31308,30001
26,027,Fronteras,9041,4580,4461
26,028,Granados,1009,524,485
26,029,Guaymas,156863,77987,78876
26,030,Hermosillo,936263,467490,468773
26,031,Huachinera,1186,607,579
26,032,Hu�sabas,888,467,421
26,033,Huatabampo,77682,39417,38265
26,034,Hu�pac,943,494,449
26,035,Imuris,12536,6401,6135
26,036,Magdalena,33049,16230,16819
26,037,Mazat�n,1101,594,507
26,038,Moctezuma,5173,2543,2630
26,039,Naco,5774,2897,2877
26,040,N�cori Chico,1531,808,723
26,041,Nacozari de Garc�a,14369,7274,7095
26,042,Navojoa,164387,81264,83123
26,043,Nogales,264782,132260,132522
26,044,�navas,365,184,181
26,045,Opodepe,2438,1325,1113
26,046,Oquitoa,496,231,265
26,047,Pitiquito,9122,4694,4428
26,048,Puerto Pe�asco,62689,31636,31053
26,049,Quiriego,3090,1618,1472
26,050,Ray�n,1496,809,687
26,051,Rosario,4830,2484,2346
26,052,Sahuaripa,5257,2719,2538
26,053,San Felipe de Jes�s,369,201,168
26,054,San Javier,537,294,243
26,055,San Luis R�o Colorado,199021,100552,98469
26,056,San Miguel de Horcasitas,10729,5607,5122
26,057,San Pedro de la Cueva,1458,793,665
26,058,Santa Ana,16203,7989,8214
26,059,Santa Cruz,1835,962,873
26,060,S�ric,2058,1079,979
26,061,Soyopa,1368,769,599
26,062,Suaqui Grande,1114,601,513
26,063,Tepache,1178,621,557
26,064,Trincheras,1381,739,642
26,065,Tubutama,1473,783,690
26,066,Ures,8548,4451,4097
26,067,Villa Hidalgo,1429,748,681
26,068,Villa Pesqueira,1043,592,451
26,069,Y�cora,4793,2415,2378
26,070,General Plutarco El�as Calles,13627,6727,6900
26,071,Benito Ju�rez,21692,10901,10791
26,072,San Ignacio R�o Muerto,14279,7342,6937
27,001,Balanc�n,58524,29242,29282
27,002,C�rdenas,243229,118795,124434
27,003,Centla,107731,53114,54617
27,004,Centro,683607,330080,353527
27,005,Comalcalco,214877,105283,109594
27,006,Cunduac�n,137257,67272,69985
27,007,Emiliano Zapata,32181,15453,16728
27,008,Huimanguillo,190885,93910,96975
27,009,Jalapa,37749,18879,18870
27,010,Jalpa de M�ndez,91185,44913,46272
27,011,Jonuta,30798,15454,15344
27,012,Macuspana,158601,77531,81070
27,013,Nacajuca,150300,72894,77406
27,014,Para�so,96741,47672,49069
27,015,Tacotalpa,47905,23754,24151
27,016,Teapa,58718,28764,29954
27,017,Tenosique,62310,30661,31649
28,001,Abasolo,9822,4898,4924
28,002,Aldama,28725,14347,14378
28,003,Altamira,269790,133306,136484
28,004,Antiguo Morelos,8850,4387,4463
28,005,Burgos,4256,2201,2055
28,006,Bustamante,7542,3853,3689
28,007,Camargo,16546,8620,7926
28,008,Casas,4143,2178,1965
28,009,Ciudad Madero,205933,98248,107685
28,010,Cruillas,1671,826,845
28,011,G�mez Far�as,8288,4230,4058
28,012,Gonz�lez,41470,20368,21102
28,013,G��mez,15032,7762,7270
28,014,Guerrero,3803,2115,1688
28,015,Gustavo D�az Ordaz,15677,7866,7811
28,016,Hidalgo,17012,8689,8323
28,017,Jaumave,15994,7992,8002
28,018,Jim�nez,6375,3171,3204
28,019,Llera,14645,7468,7177
28,020,Mainero,2048,1021,1027
28,021,El Mante,106144,50919,55225
28,022,Matamoros,541979,267898,274081
28,023,M�ndez,4280,2142,2138
28,024,Mier,6385,3383,3002
28,025,Miguel Alem�n,26237,13625,12612
28,026,Miquihuana,3704,1912,1792
28,027,Nuevo Laredo,425058,209442,215616
28,028,Nuevo Morelos,3810,1977,1833
28,029,Ocampo,13190,6730,6460
28,030,Padilla,13618,6851,6767
28,031,Palmillas,1917,961,956
28,032,Reynosa,704767,350361,354406
28,033,R�o Bravo,132484,66121,66363
28,034,San Carlos,7411,3855,3556
28,035,San Fernando,51405,25712,25693
28,036,San Nicol�s,926,494,432
28,037,Soto la Marina,23673,12103,11570
28,038,Tampico,297562,141757,155805
28,039,Tula,28230,14010,14220
28,040,Valle Hermoso,60055,29442,30613
28,041,Victoria,349688,169229,180459
28,042,Villagr�n,5361,2735,2626
28,043,Xicot�ncatl,22229,10935,11294
29,001,Amaxac de Guerrero,11403,5554,5849
29,002,Apetatitl�n de Antonio Carvajal,16003,7745,8258
29,003,Atlangatepec,7087,3458,3629
29,004,Atltzayanca,18111,8943,9168
29,005,Apizaco,80725,38467,42258
29,006,Calpulalpan,51172,24616,26556
29,007,El Carmen Tequexquitla,17332,8405,8927
29,008,Cuapiaxtla,16222,7972,8250
29,009,Cuaxomulco,5928,2902,3026
29,010,Chiautempan,73215,35251,37964
29,011,Mu�oz de Domingo Arenas,4755,2291,2464
29,012,Espa�ita,9416,4586,4830
29,013,Huamantla,98764,47761,51003
29,014,Hueyotlipan,15190,7426,7764
29,015,Ixtacuixtla de Mariano Matamoros,38970,18916,20054
29,016,Ixtenco,7504,3622,3882
29,017,Mazatecochco de Jos� Mar�a Morelos,11592,5819,5773
29,018,Contla de Juan Cuamatzi,38579,18792,19787
29,019,Tepetitla de Lardiz�bal,22274,10699,11575
29,020,Sanct�rum de L�zaro C�rdenas,9432,4583,4849
29,021,Nanacamilpa de Mariano Arista,18686,9062,9624
29,022,Acuamanala de Miguel Hidalgo,6432,3184,3248
29,023,Nat�vitas,26309,12725,13584
29,024,Panotla,28357,13419,14938
29,025,San Pablo del Monte,82688,40802,41886
29,026,Santa Cruz Tlaxcala,24116,11602,12514
29,027,Tenancingo,12974,6310,6664
29,028,Teolocholco,25257,12376,12881
29,029,Tepeyanco,13328,6358,6970
29,030,Terrenate,15475,7684,7791
29,031,Tetla de la Solidaridad,35284,17253,18031
29,032,Tetlatlahuca,13561,6521,7040
29,033,Tlaxcala,99896,47252,52644
29,034,Tlaxco,45438,22077,23361
29,035,Tocatl�n,6294,3119,3175
29,036,Totolac,22529,10728,11801
29,037,Ziltlalt�pec de Trinidad S�nchez Santos,9207,4439,4768
29,038,Tzompantepec,18006,8736,9270
29,039,Xaloztoc,25607,12746,12861
29,040,Xaltocan,10601,5013,5588
29,041,Papalotla de Xicoht�ncatl,33499,16182,17317
29,042,Xicohtzinco,14197,6762,7435
29,043,Yauhquemehcan,42242,20388,21854
29,044,Zacatelco,45717,21940,23777
29,045,Benito Ju�rez,6211,2963,3248
29,046,Emiliano Zapata,4951,2427,2524
29,047,L�zaro C�rdenas,3534,1735,1799
29,048,La Magdalena Tlaltelulco,19036,9440,9596
29,049,San Dami�n Tex�loc,5884,2922,2962
29,050,San Francisco Tetlanohcan,11761,5642,6119
29,051,San Jer�nimo Zacualpan,4092,1940,2152
29,052,San Jos� Teacalco,6436,3157,3279
29,053,San Juan Huactzinco,7688,3677,4011
29,054,San Lorenzo Axocomanitla,5689,2767,2922
29,055,San Lucas Tecopilco,3077,1541,1536
29,056,Santa Ana Nopalucan,7952,3900,4052
29,057,Santa Apolonia Teacalco,4636,2244,2392
29,058,Santa Catarina Ayometla,9463,4567,4896
29,059,Santa Cruz Quilehtla,7750,3829,3921
29,060,Santa Isabel Xiloxoxtla,5443,2657,2786
30,001,Acajete,9701,4920,4781
30,002,Acatl�n,3441,1666,1775
30,003,Acayucan,80815,38517,42298
30,004,Actopan,41742,20610,21132
30,005,Acula,5253,2670,2583
30,006,Acultzingo,23100,11178,11922
30,007,Camar�n de Tejeda,6538,3195,3343
30,008,Alpatl�huac,10338,5034,5304
30,009,Alto Lucero de Guti�rrez Barrios,28184,14006,14178
30,010,Altotonga,64234,30527,33707
30,011,Alvarado,57035,27938,29097
30,012,Amatitl�n,7866,3848,4018
30,013,Naranjos Amatl�n,26843,12669,14174
30,014,Amatl�n de los Reyes,46955,22774,24181
30,015,Angel R. Cabada,33839,16514,17325
30,016,La Antigua,28682,13737,14945
30,017,Apazapan,4709,2363,2346
30,018,Aquila,1978,929,1049
30,019,Astacinga,6909,3201,3708
30,020,Atlahuilco,11577,5594,5983
30,021,Atoyac,23461,11351,12110
30,022,Atzacan,22651,11125,11526
30,023,Atzalan,49180,24379,24801
30,024,Tlaltetela,16485,8318,8167
30,025,Ayahualulco,27217,13238,13979
30,026,Banderilla,25993,12221,13772
30,027,Benito Ju�rez,16120,7788,8332
30,028,Boca del R�o,144550,67985,76565
30,029,Calcahualco,13701,6762,6939
30,030,Camerino Z. Mendoza,41835,19687,22148
30,031,Carrillo Puerto,18888,9337,9551
30,032,Catemaco,49451,23599,25852
30,033,Cazones de Herrera,24421,11846,12575
30,034,Cerro Azul,25011,11598,13413
30,035,Citlalt�petl,11165,5478,5687
30,036,Coacoatzintla,11018,5329,5689
30,037,Coahuitl�n,8176,3990,4186
30,038,Coatepec,93911,45096,48815
30,039,Coatzacoalcos,310698,149139,161559
30,040,Coatzintla,55016,26292,28724
30,041,Coetzala,2355,1156,1199
30,042,Colipa,5743,2844,2899
30,043,Comapa,19876,9975,9901
30,044,C�rdoba,204721,95960,108761
30,045,Cosamaloapan de Carpio,54737,25879,28858
30,046,Cosautl�n de Carvajal,16167,7980,8187
30,047,Coscomatepec,59471,28715,30756
30,048,Cosoleacaque,130903,62157,68746
30,049,Cotaxtla,22050,10868,11182
30,050,Coxquihui,16333,7902,8431
30,051,Coyutla,23096,11141,11955
30,052,Cuichapa,11869,5645,6224
30,053,Cuitl�huac,28075,13510,14565
30,054,Chacaltianguis,11461,5574,5887
30,055,Chalma,13527,6521,7006
30,056,Chiconamel,6610,3143,3467
30,057,Chiconquiaco,13881,6930,6951
30,058,Chicontepec,53858,26214,27644
30,059,Chinameca,22638,10930,11708
30,060,Chinampa de Gorostiza,16283,7927,8356
30,061,Las Choapas,81080,39349,41731
30,062,Chocam�n,20839,10278,10561
30,063,Chontla,13359,6526,6833
30,064,Chumatl�n,4008,1894,2114
30,065,Emiliano Zapata,85489,41162,44327
30,066,Espinal,26830,13021,13809
30,067,Filomeno Mata,19179,9294,9885
30,068,Fort�n,66372,31242,35130
30,069,Guti�rrez Zamora,24085,11188,12897
30,070,Hidalgotitl�n,18275,9148,9127
30,071,Huatusco,59920,28610,31310
30,072,Huayacocotla,21796,10467,11329
30,073,Hueyapan de Ocampo,41670,20201,21469
30,074,Huiloapan de Cuauht�moc,7293,3457,3836
30,075,Ignacio de la Llave,16525,7959,8566
30,076,Ilamatl�n,13377,6350,7027
30,077,Isla,42807,20715,22092
30,078,Ixcatepec,12379,6080,6299
30,079,Ixhuac�n de los Reyes,11387,5617,5770
30,080,Ixhuatl�n del Caf�,23132,11460,11672
30,081,Ixhuatlancillo,27295,12909,14386
30,082,Ixhuatl�n del Sureste,15831,7768,8063
30,083,Ixhuatl�n de Madero,50836,24723,26113
30,084,Ixmatlahuacan,5574,2712,2862
30,085,Ixtaczoquitl�n,74004,35363,38641
30,086,Jalacingo,46794,22644,24150
30,087,Xalapa,488531,226821,261710
30,088,Jalcomulco,5054,2537,2517
30,089,J�ltipan,38669,18192,20477
30,090,Jamapa,11132,5420,5712
30,091,Jes�s Carranza,28524,14079,14445
30,092,Xico,39623,19253,20370
30,093,Jilotepec,16585,8015,8570
30,094,Juan Rodr�guez Clara,38367,18690,19677
30,095,Juchique de Ferrer,15059,7478,7581
30,096,Landero y Coss,1543,756,787
30,097,Lerdo de Tejada,19123,8984,10139
30,098,Magdalena,3299,1591,1708
30,099,Maltrata,18327,8778,9549
30,100,Manlio Fabio Altamirano,23918,11737,12181
30,101,Mariano Escobedo,38670,18520,20150
30,102,Mart�nez de la Torre,108842,52176,56666
30,103,Mecatl�n,12799,6296,6503
30,104,Mecayapan,17134,8228,8906
30,105,Medell�n de Bravo,95202,45685,49517
30,106,Miahuatl�n,4841,2406,2435
30,107,Las Minas,2934,1453,1481
30,108,Minatitl�n,144776,68789,75987
30,109,Misantla,65761,32030,33731
30,110,Mixtla de Altamirano,12125,5982,6143
30,111,Moloac�n,16493,7953,8540
30,112,Naolinco,22835,11126,11709
30,113,Naranjal,4614,2232,2382
30,114,Nautla,10130,5050,5080
30,115,Nogales,37314,17775,19539
30,116,Oluta,17027,8178,8849
30,117,Omealca,23773,11420,12353
30,118,Orizaba,123182,56740,66442
30,119,Otatitl�n,5651,2739,2912
30,120,Oteapan,10343,4913,5430
30,121,Ozuluama de Mascare�as,22756,11612,11144
30,122,Pajapan,18051,8880,9171
30,123,P�nuco,96185,47219,48966
30,124,Papantla,159910,77178,82732
30,125,Paso del Macho,31894,15617,16277
30,126,Paso de Ovejas,33442,16531,16911
30,127,La Perla,28258,13717,14541
30,128,Perote,77432,38295,39137
30,129,Plat�n S�nchez,18053,8687,9366
30,130,Playa Vicente,39327,18844,20483
30,131,Poza Rica de Hidalgo,189457,88204,101253
30,132,Las Vigas de Ram�rez,20300,9962,10338
30,133,Pueblo Viejo,57909,28756,29153
30,134,Puente Nacional,23544,11493,12051
30,135,Rafael Delgado,24127,11804,12323
30,136,Rafael Lucio,8343,4024,4319
30,137,Los Reyes,6308,3097,3211
30,138,R�o Blanco,41795,19312,22483
30,139,Saltabarranca,6126,2952,3174
30,140,San Andr�s Tenejapan,3134,1520,1614
30,141,San Andr�s Tuxtla,162428,76986,85442
30,142,San Juan Evangelista,32631,15998,16633
30,143,Santiago Tuxtla,57085,27104,29981
30,144,Sayula de Alem�n,32400,15629,16771
30,145,Soconusco,16574,7926,8648
30,146,Sochiapa,3925,1956,1969
30,147,Soledad Atzompa,24578,12001,12577
30,148,Soledad de Doblado,28130,13872,14258
30,149,Soteapan,34385,16531,17854
30,150,Tamal�n,11631,5821,5810
30,151,Tamiahua,21902,10992,10910
30,152,Tampico Alto,11561,5927,5634
30,153,Tancoco,5795,2785,3010
30,154,Tantima,11991,6075,5916
30,155,Tantoyuca,99959,48133,51826
30,156,Tatatila,6041,3091,2950
30,157,Castillo de Teayo,20145,9936,10209
30,158,Tecolutla,24551,12102,12449
30,159,Tehuipango,29686,14225,15461
30,160,�lamo Temapache,107270,52748,54522
30,161,Tempoal,34408,16866,17542
30,162,Tenampa,6448,3225,3223
30,163,Tenochtitl�n,5040,2482,2558
30,164,Teocelo,16957,8217,8740
30,165,Tepatlaxco,8925,4530,4395
30,166,Tepetl�n,9405,4807,4598
30,167,Tepetzintla,14619,7196,7423
30,168,Tequila,16343,8066,8277
30,169,Jos� Azueta,22709,11136,11573
30,170,Texcatepec,10824,5274,5550
30,171,Texhuac�n,5575,2644,2931
30,172,Texistepec,19925,9801,10124
30,173,Tezonapa,54537,26811,27726
30,174,Tierra Blanca,95602,45759,49843
30,175,Tihuatl�n,92726,44657,48069
30,176,Tlacojalpan,4489,2219,2270
30,177,Tlacolulan,11685,5751,5934
30,178,Tlacotalpan,12898,6223,6675
30,179,Tlacotepec de Mej�a,4284,2130,2154
30,180,Tlachichilco,10900,5307,5593
30,181,Tlalixcoyan,37795,18380,19415
30,182,Tlalnelhuayocan,19664,9585,10079
30,183,Tlapacoyan,61377,29598,31779
30,184,Tlaquilpa,7933,3711,4222
30,185,Tlilapan,5548,2693,2855
30,186,Tomatl�n,7197,3538,3659
30,187,Tonay�n,6105,2956,3149
30,188,Totutla,17217,8525,8692
30,189,Tuxpan,154600,74195,80405
30,190,Tuxtilla,2258,1114,1144
30,191,Ursulo Galv�n,30097,14468,15629
30,192,Vega de Alatorre,20204,9772,10432
30,193,Veracruz,607209,287664,319545
30,194,Villa Aldama,12492,6113,6379
30,195,Xoxocotla,5900,2961,2939
30,196,Yanga,17902,8425,9477
30,197,Yecuatla,11205,5543,5662
30,198,Zacualpan,6788,3238,3550
30,199,Zaragoza,11899,5637,6262
30,200,Zentla,12581,6288,6293
30,201,Zongolica,45028,21765,23263
30,202,Zontecomatl�n de L�pez y Fuentes,14644,7154,7490
30,203,Zozocolco de Hidalgo,14524,7020,7504
30,204,Agua Dulce,44104,21064,23040
30,205,El Higo,19402,9635,9767
30,206,Nanchital de L�zaro C�rdenas del R�o,29209,13887,15322
30,207,Tres Valles,44978,21699,23279
30,208,Carlos A. Carrillo,23376,11090,12286
30,209,Tatahuicapan de Ju�rez,15044,7183,7861
30,210,Uxpanapa,30891,15440,15451
30,211,San Rafael,30351,14897,15454
30,212,Santiago Sochiapan,13062,6315,6747
31,001,Abal�,6550,3303,3247
31,002,Acanceh,16772,8379,8393
31,003,Akil,12285,6100,6185
31,004,Baca,6195,3043,3152
31,005,Bokob�,2167,1089,1078
31,006,Buctzotz,9159,4634,4525
31,007,Cacalch�n,7490,3769,3721
31,008,Calotmul,3949,1987,1962
31,009,Cansahcab,4466,2188,2278
31,010,Cantamayec,2755,1423,1332
31,011,Celest�n,8389,4235,4154
31,012,Cenotillo,3736,1856,1880
31,013,Conkal,16671,8170,8501
31,014,Cuncunul,1714,885,829
31,015,Cuzam�,5560,2821,2739
31,016,Chacsink�n,3104,1588,1516
31,017,Chankom,4686,2359,2327
31,018,Chapab,3385,1698,1687
31,019,Chemax,38934,19575,19359
31,020,Chicxulub Pueblo,4497,2279,2218
31,021,Chichimil�,9406,4775,4631
31,022,Chikindzonot,4363,2192,2171
31,023,Chochol�,4863,2490,2373
31,024,Chumayel,3244,1597,1647
31,025,Dz�n,6003,2939,3064
31,026,Dzemul,3622,1797,1825
31,027,Dzidzant�n,8345,4211,4134
31,028,Dzilam de Bravo,2936,1474,1462
31,029,Dzilam Gonz�lez,6240,3173,3067
31,030,Dzit�s,4015,2056,1959
31,031,Dzoncauich,2818,1422,1396
31,032,Espita,16779,8512,8267
31,033,Halach�,21255,10673,10582
31,034,Hocab�,6514,3249,3265
31,035,Hoct�n,6384,3174,3210
31,036,Hom�n,8090,4069,4021
31,037,Huh�,5250,2698,2552
31,038,Hunucm�,35137,17457,17680
31,039,Ixil,4186,2100,2086
31,040,Izamal,28555,14200,14355
31,041,Kanas�n,141939,70412,71527
31,042,Kantunil,5553,2730,2823
31,043,Kaua,3405,1724,1681
31,044,Kinchil,7530,3792,3738
31,045,Kopom�,2677,1387,1290
31,046,Mama,3296,1615,1681
31,047,Man�,5968,2944,3024
31,048,Maxcan�,23991,12108,11883
31,049,Mayap�n,3965,2069,1896
31,050,M�rida,995129,479369,515760
31,051,Mococh�,3430,1757,1673
31,052,Motul,37804,18677,19127
31,053,Muna,13494,6747,6747
31,054,Muxupip,2990,1459,1531
31,055,Opich�n,7080,3577,3503
31,056,Oxkutzcab,33854,16310,17544
31,057,Panab�,7766,3836,3930
31,058,Peto,25954,12887,13067
31,059,Progreso,66008,32979,33029
31,060,Quintana Roo,976,480,496
31,061,R�o Lagartos,3974,2033,1941
31,062,Sacalum,4962,2560,2402
31,063,Samahil,5631,2835,2796
31,064,Sanahcat,1701,858,843
31,065,San Felipe,2118,1089,1029
31,066,Santa Elena,4220,2102,2118
31,067,Sey�,10053,5129,4924
31,068,Sinanch�,3206,1648,1558
31,069,Sotuta,8967,4582,4385
31,070,Sucil�,3971,1981,1990
31,071,Sudzal,1949,999,950
31,072,Suma,1857,963,894
31,073,Tahdzi�,5854,3009,2845
31,074,Tahmek,3774,1909,1865
31,075,Teabo,6921,3446,3475
31,076,Tecoh,17939,9041,8898
31,077,Tekal de Venegas,2683,1371,1312
31,078,Tekant�,3747,1884,1863
31,079,Tekax,45062,22128,22934
31,080,Tekit,11020,5586,5434
31,081,Tekom,3355,1665,1690
31,082,Telchac Pueblo,3512,1711,1801
31,083,Telchac Puerto,1915,953,962
31,084,Temax,7037,3543,3494
31,085,Temoz�n,16680,8420,8260
31,086,Tepak�n,2133,1068,1065
31,087,Tetiz,5464,2784,2680
31,088,Teya,1917,955,962
31,089,Ticul,40495,19937,20558
31,090,Timucuy,7503,3788,3715
31,091,Tinum,12700,6385,6315
31,092,Tixcacalcupul,7888,3939,3949
31,093,Tixkokob,18420,9037,9383
31,094,Tixmehuac,5444,2718,2726
31,095,Tixp�hual,5690,2816,2874
31,096,Tizim�n,80672,40054,40618
31,097,Tunk�s,3684,1889,1795
31,098,Tzucacab,15346,7669,7677
31,099,Uayma,4191,2091,2100
31,100,Uc�,4049,2015,2034
31,101,Um�n,69147,34422,34725
31,102,Valladolid,85460,41925,43535
31,103,Xocchel,3451,1750,1701
31,104,Yaxcab�,16350,8356,7994
31,105,Yaxkukul,3293,1628,1665
31,106,Yoba�n,2215,1110,1105
32,001,Apozol,6260,3041,3219
32,002,Apulco,4942,2339,2603
32,003,Atolinga,2277,1131,1146
32,004,Benito Ju�rez,4493,2242,2251
32,005,Calera,45759,22579,23180
32,006,Ca�itas de Felipe Pescador,8255,4027,4228
32,007,Concepci�n del Oro,12115,6065,6050
32,008,Cuauht�moc,13466,6548,6918
32,009,Chalchihuites,10086,4892,5194
32,010,Fresnillo,240532,117767,122765
32,011,Trinidad Garc�a de la Cadena,3362,1656,1706
32,012,Genaro Codina,8168,3943,4225
32,013,General Enrique Estrada,6644,3281,3363
32,014,General Francisco R. Murgu�a,20191,9774,10417
32,015,El Plateado de Joaqu�n Amaro,1579,781,798
32,016,General P�nfilo Natera,23526,11441,12085
32,017,Guadalupe,211740,102455,109285
32,018,Huanusco,4547,2257,2290
32,019,Jalpa,25296,12428,12868
32,020,Jerez,59910,29165,30745
32,021,Jim�nez del Teul,4465,2210,2255
32,022,Juan Aldama,19749,9565,10184
32,023,Juchipila,12251,5887,6364
32,024,Loreto,53709,26267,27442
32,025,Luis Moya,13184,6434,6750
32,026,Mazapil,17774,9111,8663
32,027,Melchor Ocampo,2736,1455,1281
32,028,Mezquital del Oro,2451,1216,1235
32,029,Miguel Auza,23713,11575,12138
32,030,Momax,2446,1185,1261
32,031,Monte Escobedo,8683,4284,4399
32,032,Morelos,13207,6552,6655
32,033,Moyahua de Estrada,4530,2218,2312
32,034,Nochistl�n de Mej�a,27945,13482,14463
32,035,Noria de �ngeles,16284,7900,8384
32,036,Ojocaliente,44144,21262,22882
32,037,P�nuco,17577,8780,8797
32,038,Pinos,72241,34756,37485
32,039,R�o Grande,64535,31280,33255
32,040,Sain Alto,21844,10643,11201
32,041,El Salvador,2509,1274,1235
32,042,Sombrerete,63665,31467,32198
32,043,Susticac�n,1365,664,701
32,044,Tabasco,16588,8107,8481
32,045,Tepechitl�n,8321,3984,4337
32,046,Tepetongo,6490,3206,3284
32,047,Te�l de Gonz�lez Ortega,5356,2612,2744
32,048,Tlaltenango de S�nchez Rom�n,27302,13224,14078
32,049,Valpara�so,32461,16029,16432
32,050,Vetagrande,10276,5005,5271
32,051,Villa de Cos,34623,17255,17368
32,052,Villa Garc�a,19525,9627,9898
32,053,Villa Gonz�lez Ortega,13208,6275,6933
32,054,Villa Hidalgo,19446,9504,9942
32,055,Villanueva,31558,15590,15968
32,056,Zacatecas,149607,71972,77635
32,057,Trancoso,20455,10039,10416
32,058,Santa Mar�a de la Paz,2767,1350,1417